"BsmtFin SF 1","Bsmt Unf SF","Total Bsmt SF","1st Flr SF","2nd Flr SF","Gr Liv Area","SalePrice"
639,441,1080,1656,0,1656,215000
468,270,882,896,0,896,105000
923,406,1329,1329,0,1329,172000
1065,1045,2110,2110,0,2110,244000
791,137,928,928,701,1629,189900
602,324,926,926,678,1604,195500
616,722,1338,1338,0,1338,213500
263,1017,1280,1280,0,1280,191500
1180,415,1595,1616,0,1616,236500
0,994,994,1028,776,1804,189000
0,763,763,763,892,1655,175900
935,233,1168,1187,0,1187,185000
0,789,789,789,676,1465,180400
637,663,1300,1341,0,1341,171500
368,0,1488,1502,0,1502,212000
1416,234,1650,1690,1589,3279,538000
427,132,559,1080,672,1752,164000
1445,411,1856,1856,0,1856,394432
120,744,864,864,0,864,141000
790,589,1542,2073,0,2073,210000
705,1139,1844,1844,0,1844,190000
885,0,1053,1173,0,1173,170000
533,281,814,814,860,1674,216000
578,426,1004,1004,0,1004,149000
734,344,1078,1078,0,1078,149900
775,281,1056,1056,0,1056,142000
804,0,882,882,0,882,126000
432,432,864,864,0,864,115000
1051,354,1405,1337,0,1337,184000
156,327,483,483,504,987,96000
300,225,525,525,567,1092,105500
0,525,525,525,567,1092,88000
360,709,1069,1069,0,1069,127500
514,341,855,855,601,1456,149900
0,836,836,836,0,836,120000
311,544,855,855,601,1456,146000
0,1590,1590,1627,707,2334,376162
1218,486,1704,1704,0,1704,306000
1646,284,1930,1940,0,1940,395192
0,1544,1544,1544,0,1544,290941
1201,340,1541,1541,0,1541,220000
110,1588,1698,1698,0,1698,275000
28,1794,1822,1822,0,1822,259000
2,1515,1517,1535,0,1535,214000
2188,142,2330,2364,0,2364,611657
733,625,1358,1358,0,1358,224000
1373,1473,2846,2696,0,2696,500000
578,1093,1671,1687,563,2250,320000
456,1296,1752,1752,0,1752,319900
24,1346,1370,1370,0,1370,205000
0,764,764,764,862,1626,175500
0,1324,1324,1324,0,1324,199500
16,1129,1145,1145,0,1145,160000
24,1232,1256,1269,0,1269,192000
326,58,384,744,630,1374,184500
625,235,860,860,1100,1960,216500
0,847,847,847,886,1733,185088
250,134,384,774,656,1430,180000
0,884,884,884,1151,2035,222500
0,1393,1393,1422,1177,2599,333168
0,1629,1629,1645,830,2475,355000
919,801,1720,1720,0,1720,260400
1032,431,1463,1500,1122,2622,325000
524,628,1152,1164,1106,2270,290000
0,1195,1195,1195,644,1839,221000
816,1217,2033,2053,1185,3238,410000
0,1595,1595,1595,0,1595,221500
0,1218,1218,1218,0,1218,204500
24,732,756,764,783,1547,215200
1078,488,1566,1566,0,1566,262500
222,769,991,991,956,1947,254900
1414,54,1468,1468,0,1468,271500
656,300,956,956,1128,2084,233000
0,831,831,831,828,1659,181000
695,253,948,1222,888,2110,205000
543,261,923,923,0,923,143000
0,1055,1055,1055,790,1845,189000
0,918,918,918,0,918,99500
623,0,744,752,0,752,125000
402,594,996,1014,730,1744,194500
338,702,1040,1097,0,1097,152000
0,650,650,888,676,1564,171000
0,816,816,1012,0,1012,67500
0,0,0,1318,584,1902,112000
899,210,1109,1155,0,1155,148000
553,224,894,894,0,894,138500
450,432,882,900,0,900,122000
824,216,1040,1040,0,1040,133000
659,381,1040,1040,0,1040,127000
126,223,1208,1494,0,1494,169000
674,76,750,1061,862,1923,190000
250,0,1231,1251,1098,2349,362500
1129,261,1390,1402,823,2225,285000
1298,190,1488,1488,0,1488,260000
0,840,840,840,840,1680,190000
280,320,600,600,600,1200,155000
0,600,600,600,600,1200,151000
368,190,600,600,600,1200,149500
376,224,600,600,636,1236,152000
578,892,1470,1478,0,1478,222000
378,378,756,769,804,1573,177500
466,290,756,756,756,1512,177000
604,92,696,696,720,1416,155000
244,286,530,530,550,1080,147110
1032,610,1642,1418,0,1418,267916
484,491,975,975,873,1848,254000
728,0,728,788,0,788,155000
1052,174,1226,1226,0,1226,206000
533,192,725,725,754,1479,130500
833,659,1492,1492,0,1492,230000
506,1323,1829,1829,0,1829,218500
1137,143,1280,1280,1215,2495,243500
1200,410,1610,1610,0,1610,205000
687,491,1224,1287,604,1891,212500
394,586,980,980,734,1714,196500
982,179,1161,1381,0,1381,197500
329,386,715,930,715,1645,171000
698,534,1232,1232,0,1232,142250
569,678,1328,1328,0,1328,143000
569,381,950,1225,0,1225,128950
1059,150,1209,1209,0,1209,159000
1010,500,1510,1510,0,1510,178900
0,533,533,1131,644,1775,136300
1014,138,1152,1152,0,1152,180500
763,173,936,1054,0,1054,137500
1500,228,1728,1728,0,1728,84900
49,0,1078,1078,0,1078,142125
670,470,1140,1929,532,2461,197600
300,482,782,1019,537,1556,172500
696,162,858,858,0,858,116500
0,728,728,1306,0,1306,76500
354,412,1056,1063,0,1063,128000
674,350,1156,1520,0,1520,153000
540,728,1268,1268,0,1268,132000
944,136,1080,1128,0,1128,178000
443,662,1105,1105,1169,2274,154300
912,1035,1947,2207,0,2207,180000
247,557,1517,1888,0,1888,190000
0,1604,1604,1604,0,1604,135000
1188,292,1480,1480,0,1480,214000
856,125,1143,1143,0,1143,136000
1018,380,1398,1700,0,1700,165500
922,392,1314,1314,0,1314,145000
0,1194,1194,1194,0,1194,148000
1000,188,1188,1188,0,1188,142000
697,571,1268,1264,0,1264,167500
936,270,1206,1206,0,1206,108538
734,510,1244,1580,0,1580,159500
0,832,832,832,505,1337,108000
339,525,864,1064,0,1064,135000
648,324,972,972,0,972,122500
532,456,988,988,0,988,119000
731,326,1057,1057,0,1057,109000
0,576,576,985,0,985,105000
0,0,0,827,0,827,107500
320,404,1086,1086,0,1086,144900
248,448,936,936,0,936,129000
0,912,912,912,546,1458,97500
1056,0,1056,1056,0,1056,144000
72,733,1063,1287,0,1287,162000
0,710,710,1898,1080,2978,242000
481,161,816,816,408,1224,132000
340,0,1246,1246,0,1246,154000
507,403,910,910,475,1385,166000
234,180,900,900,0,900,134800
0,1116,1116,1116,0,1116,160000
588,237,1175,1175,0,1175,148000
717,415,1395,1395,0,1395,192000
0,756,756,1051,788,1839,155000
48,661,709,1157,687,1844,80400
0,576,576,792,348,1140,96500
579,357,936,936,0,936,109500
0,1008,1008,1028,0,1028,115000
274,0,1347,1347,0,1347,143000
0,840,840,840,765,1605,107400
0,747,747,747,0,747,80000
510,278,788,804,0,804,119000
234,0,926,926,0,1316,130000
0,827,827,827,424,1251,119000
780,247,1027,1027,606,1633,129000
176,832,1008,1060,185,1245,100000
0,678,678,832,0,832,12789
0,624,624,720,0,720,105900
0,930,930,930,636,1566,150000
686,0,686,966,686,1652,139000
0,346,346,1157,1111,2268,240000
0,840,840,1128,1128,2256,76500
600,312,912,1236,0,1236,149700
0,622,622,741,622,1363,125500
0,777,777,1246,1044,2290,122500
283,455,738,868,602,1470,140750
788,200,988,1030,582,1612,128500
474,634,1108,1160,908,2068,209500
188,577,765,765,0,765,87000
452,144,608,608,524,1132,134000
264,308,572,848,348,1196,128000
360,316,835,955,498,1453,132000
300,480,780,780,636,1416,139900
276,252,528,548,492,1040,123900
448,480,928,928,608,1536,138400
960,164,1124,1068,0,1068,109500
0,576,576,902,808,1710,140000
0,888,888,888,1074,1962,149500
0,780,780,780,780,1560,159900
0,662,662,662,662,1324,122000
104,0,816,816,0,816,110000
0,0,0,372,720,1092,55000
0,360,360,1032,780,1812,140000
0,1032,1032,1207,1196,2403,244400
766,656,1422,1675,0,1675,173000
0,689,689,725,499,1224,107500
1026,186,1212,1212,180,1392,100000
368,232,600,600,319,919,95000
73,634,707,942,942,1884,93369
736,120,856,936,744,1680,114900
0,780,780,780,240,1020,94000
704,1128,1832,1832,0,1832,136000
0,1768,1768,1768,0,1768,136500
841,198,1039,1039,0,1039,131500
1302,90,1392,1392,0,1392,121500
842,70,912,912,0,912,125000
188,204,1060,1060,0,1060,154000
240,150,864,892,0,892,137900
371,292,663,663,689,1352,158000
775,89,864,864,0,864,137250
1319,0,1319,1373,0,1373,160250
267,0,720,720,720,1440,163000
438,234,672,672,714,1386,158900
1201,105,1306,1306,954,2260,328000
1092,328,1420,1483,0,1483,270000
0,660,660,756,0,756,85000
442,625,1067,1067,0,1067,128000
1258,74,1332,1332,192,1524,260000
964,153,1117,1117,864,1981,230000
288,0,972,1052,558,1610,124000
108,350,458,835,0,835,83000
104,172,663,1074,0,1074,144500
739,405,1144,1144,0,1144,129000
192,564,756,1169,0,1531,127000
954,218,1172,1172,0,1172,128000
36,1176,1212,1212,0,1212,186000
1346,162,1508,1508,0,1508,308030
0,1250,1250,1298,0,1298,114000
0,0,0,930,0,930,84900
0,741,741,977,755,1732,178000
1433,0,1433,1433,0,1433,270000
860,86,946,964,838,1802,218000
750,300,1050,1062,887,1949,236000
747,189,936,996,0,996,147000
0,1694,1694,1694,0,1694,245350
686,501,1187,1208,0,1208,206000
0,1226,1226,1226,0,1226,198900
24,1198,1222,1222,0,1222,187000
1470,203,1673,1699,1523,3222,320000
0,676,676,831,614,1445,138500
504,506,1010,1052,0,1052,155000
870,0,870,965,0,965,159000
353,525,878,892,800,1692,191000
505,299,804,804,878,1682,200500
198,140,1026,1026,0,1026,150000
378,311,689,689,703,1392,161750
182,0,894,894,0,894,128200
480,396,876,876,0,876,127000
1682,296,1978,1978,0,1978,318000
1358,223,1581,1601,0,1601,272000
483,458,941,941,888,1829,237000
0,1040,1040,1044,1054,2098,240000
0,1649,1649,1661,0,1661,224900
672,176,848,848,0,848,143750
662,186,848,848,0,848,143000
370,315,1657,1668,0,1668,232000
712,761,1473,1484,0,1484,213000
24,1390,1414,1414,0,1414,185500
0,0,0,640,0,640,84900
0,381,381,992,0,992,155891
0,0,0,1664,0,1664,100000
1070,126,1196,1196,0,1196,144000
0,744,744,792,328,1120,64000
528,480,1008,1096,0,1096,125200
422,480,1029,1117,0,1117,107000
0,960,960,960,0,960,90000
0,1121,1121,1121,0,1121,140000
94,641,735,798,689,1487,113000
348,324,672,672,252,924,80000
383,833,1216,1526,0,1526,144500
133,974,1107,1296,0,1296,104000
0,806,806,841,806,1647,128000
203,661,864,864,0,864,58500
218,808,1026,1026,665,1691,127000
238,618,856,856,0,856,126000
0,0,0,862,1788,2650,160000
0,894,894,894,772,1666,100000
0,804,804,1699,748,2447,169000
426,850,1528,1225,908,2133,257500
375,657,1032,1102,1075,2177,215000
275,877,1152,1188,1152,2340,266500
1406,496,1902,1902,0,1902,335000
343,80,423,896,756,1652,203135
747,235,982,1034,0,1034,185000
76,1115,1191,1191,0,1191,162500
1247,254,1501,1801,0,1801,289000
735,61,796,796,358,1154,125500
480,0,480,540,0,540,82000
308,321,629,727,380,1107,110000
0,698,698,698,430,1128,68400
0,859,859,859,319,1178,102776
0,540,540,1044,0,1044,55993
0,756,756,952,0,952,50138
1373,221,1594,1646,0,1646,246000
615,434,1049,1036,880,1916,254900
679,564,1243,1285,0,1285,190000
0,1560,1560,1560,0,1560,201000
539,473,1012,1034,0,1034,169900
0,1958,1958,2048,0,2048,170000
353,60,747,1687,0,1687,160000
78,1258,1336,1346,0,1346,220000
0,1214,1214,1214,0,1214,179781
0,384,384,744,700,1444,174000
0,774,774,774,1194,1968,269500
624,193,817,824,1070,1894,214900
0,967,967,993,915,1908,202900
0,2002,2002,2018,0,2018,378500
42,1026,1068,1264,0,1264,169000
0,1430,1430,1430,0,1430,173500
0,912,912,912,912,1824,139000
0,1344,1344,1344,0,1344,166500
334,212,546,546,546,1092,83500
915,30,945,945,0,945,119500
129,175,536,536,576,1112,85000
176,370,546,546,546,1092,76000
150,0,630,630,0,630,75500
0,546,546,546,546,1092,88250
294,252,546,546,546,1092,85500
469,395,864,874,0,874,130000
593,595,1188,1188,0,1188,157900
207,36,833,833,0,833,149900
0,1216,1216,1216,1216,2432,159000
458,166,624,624,650,1274,136000
476,388,864,864,615,1479,161000
1341,54,1679,1803,0,1803,285000
944,208,1152,1152,645,1797,231000
564,318,882,882,0,882,124500
844,590,1434,1434,0,1434,157000
1410,542,1952,2000,704,2704,345000
847,98,945,945,663,1608,189500
850,158,1008,1008,1275,2283,270000
284,100,384,958,670,1628,189000
1320,426,1746,1746,0,1746,377500
0,384,384,804,670,1474,168500
1965,243,2208,2522,0,2522,375000
1158,343,1501,1659,0,1659,278000
341,1077,1418,1478,0,1478,240000
741,846,1587,1734,0,1734,239500
189,195,384,751,631,1382,177500
0,832,832,885,833,1718,185000
476,476,952,952,684,1636,191000
0,799,799,799,772,1571,178000
310,370,680,680,790,1470,185000
600,107,707,707,809,1516,181316
0,1181,1181,1190,0,1190,166000
0,808,808,808,785,1593,178000
0,702,702,702,779,1481,174000
560,598,1158,1167,0,1167,173000
694,284,978,1005,978,1983,225000
0,1424,1424,1442,0,1442,180500
1036,184,1220,1360,0,1360,187500
1904,312,2216,2234,0,2234,501837
0,2046,2046,2046,0,2046,372500
1274,256,1530,1530,0,1530,260000
400,722,1122,946,988,1934,185000
692,153,845,1153,1200,2353,260000
0,1362,1362,1586,0,1586,181000
822,564,1386,1411,0,1411,82500
1246,356,1602,1602,0,1602,215000
0,832,832,1154,896,2050,154000
363,1064,1427,1671,0,1671,200000
602,441,1043,1539,1134,2673,249000
1036,336,1372,1472,0,1472,187500
832,308,1140,1707,0,1707,184000
1104,1420,2524,2524,0,2524,278000
704,567,1271,1601,0,1601,157000
0,1090,1090,1370,0,1370,152000
381,399,780,1088,780,1868,197500
622,304,926,1016,868,1884,240900
544,288,832,832,1103,1935,263435
0,1058,1058,1058,816,1874,220000
225,471,972,972,839,1811,235000
1333,120,1621,1621,0,1621,213000
888,228,1116,1116,0,1116,167900
636,540,1176,1193,0,1193,158000
0,1064,1064,1350,0,1350,165000
0,689,689,1378,741,2119,158000
0,896,896,896,896,1792,136000
828,174,1002,1002,0,1002,148500
439,115,1026,1026,0,1026,156000
0,1180,1180,1180,0,1180,128000
500,543,1043,1050,0,1050,143000
726,138,864,864,0,864,76500
375,250,864,864,0,864,120500
191,673,864,864,0,864,124500
524,160,864,864,0,864,97000
240,624,864,864,0,864,130000
254,229,483,483,504,987,111000
765,0,765,765,600,1365,125000
0,630,630,630,672,1302,112000
110,79,483,483,504,987,97000
162,321,483,483,504,987,118000
231,399,630,630,672,1302,119500
958,0,958,958,0,958,143750
306,498,804,804,744,1548,146000
566,289,855,855,601,1456,148500
435,0,1057,1055,0,1055,123000
257,103,855,855,467,1322,147000
389,466,855,855,601,1456,137900
320,484,804,804,744,1548,147000
311,544,855,855,586,1441,148500
279,576,855,855,601,1456,138000
536,300,836,836,0,836,128500
432,460,892,892,0,892,100000
644,220,864,1120,0,1120,148800
1172,528,1700,1718,0,1718,337500
1360,416,1776,1794,978,2772,462000
0,1926,1926,1966,1174,3140,485000
1767,788,3094,2402,0,2402,555000
1572,80,1652,1652,0,1652,325000
0,1566,1566,1600,0,1600,256300
0,2042,2042,2042,0,2042,253293
986,379,1365,1365,1325,2690,398800
936,168,1104,1130,1054,2184,335000
1232,788,2020,2020,0,2020,404000
1436,570,2006,2020,0,2020,402861
1338,384,1722,1728,568,2296,451950
2288,342,2630,2674,0,2674,610000
0,1734,1734,1734,1088,2822,582933
0,1736,1736,1736,0,1736,360000
1531,251,1782,1782,0,1782,296000
1230,278,1508,1508,1012,2520,409900
0,1709,1709,1717,0,1717,255500
1015,724,1739,1743,0,1743,335000
1088,625,1713,1713,0,1713,274900
1037,467,1504,1531,0,1531,300000
1142,632,1774,1808,0,1808,324000
1170,292,1462,1462,762,2224,350000
1039,797,1836,1836,0,1836,280000
1124,1603,3206,1629,0,1629,284000
1262,498,1760,1760,0,1760,269500
0,1502,1502,1502,0,1502,233170
56,2336,2392,2392,0,2392,386250
1972,480,2452,2452,0,2452,445000
0,1082,1082,1105,1295,2400,290000
0,1598,1598,1606,0,1606,255900
836,522,1358,1358,0,1358,213000
900,406,1306,1306,0,1306,196000
881,425,1306,1306,0,1306,184500
876,474,1350,1358,0,1358,212500
904,410,1314,1314,0,1314,230000
2146,346,2492,2492,0,2492,552000
1557,643,2200,2200,0,2200,382500
800,1084,1884,1884,0,1884,320000
0,1451,1451,1456,0,1456,248500
1196,516,1712,1712,0,1712,286500
863,461,1324,1324,0,1324,254000
0,1405,1405,1405,0,1405,173000
567,197,764,764,862,1626,173000
0,728,728,728,728,1456,184000
0,745,745,745,745,1490,167800
0,742,742,742,742,1484,174000
0,684,684,684,876,1560,174000
0,1373,1373,1555,0,1555,174000
988,398,1386,1569,0,1569,175900
16,1357,1373,1555,0,1555,192500
16,1330,1346,1504,0,1504,181000
16,1204,1220,1220,0,1220,180000
16,1129,1145,1145,0,1145,160200
425,291,716,716,716,1432,188500
0,1010,1010,1010,1257,2267,200000
0,384,384,744,630,1374,170000
0,868,868,868,762,1630,189500
353,55,408,779,640,1419,184100
0,846,846,846,748,1594,195500
652,130,782,806,683,1489,192000
494,204,698,698,644,1342,178000
904,410,1314,1314,0,1314,207500
300,652,952,980,1276,2256,236000
651,219,870,878,1126,2004,257500
695,297,992,1022,1032,2054,244000
241,30,384,744,630,1374,167000
0,982,982,1007,793,1800,179000
683,111,794,819,695,1514,190000
0,384,384,774,656,1430,156000
913,264,1177,1223,1089,2312,245000
0,841,841,892,783,1675,181000
772,220,992,1022,1038,2060,214000
0,384,384,774,656,1430,168000
1163,89,1252,1268,1097,2365,337000
689,773,1462,1490,1304,2794,403000
1173,282,1455,1466,1221,2687,327000
781,503,1284,1310,1140,2450,340000
854,371,1225,1276,1336,2612,336000
0,1264,1264,1277,1067,2344,265000
236,262,2024,2063,0,2063,315000
987,360,1347,1372,1274,2646,260000
816,254,1070,1094,967,2061,260000
624,549,1173,1215,1017,2232,263550
1361,88,1629,1686,762,2448,402000
595,378,973,979,871,1850,248000
0,1468,1468,1468,0,1468,244600
0,1696,1696,1696,0,1696,275000
0,1614,1614,1658,0,1658,257500
0,1573,1573,1578,0,1578,287090
1294,408,1702,1702,0,1702,275500
379,1043,1422,1432,0,1432,245000
341,772,1113,1113,858,1971,253000
2158,300,2458,2490,0,2490,468000
822,78,900,932,920,1852,252678
0,768,768,786,804,1590,210000
27,1191,1218,1218,0,1218,208300
0,1436,1436,1436,0,1436,225000
936,364,1300,1314,0,1314,229456
0,1402,1402,1402,0,1402,229800
0,1530,1530,1530,0,1530,250000
1121,645,1766,1766,0,1766,370878
24,1348,1372,1448,0,1448,238500
765,252,1017,1026,981,2007,310000
682,218,900,909,886,1795,270000
0,1082,1082,1082,871,1953,252000
812,280,1092,1112,438,1550,241000
0,1836,1836,1836,0,1836,264500
1430,222,1652,1662,0,1662,291000
0,912,912,912,1182,2094,263000
410,811,1221,1221,0,1221,185000
771,422,1553,1553,0,1553,234500
410,402,812,812,841,1653,209000
0,1218,1218,1218,0,1218,159000
54,1087,1141,1141,0,1141,152000
0,1158,1158,1158,0,1158,143500
0,835,835,871,941,1812,193000
516,222,1512,1512,0,1512,203000
833,343,1176,1200,0,1200,184900
0,1114,1114,1114,0,1114,159000
0,1114,1114,1114,0,1114,142000
836,278,1114,1114,0,1114,153000
0,1450,1450,1450,0,1450,224243
637,276,913,913,1209,2122,220000
976,868,1844,1844,0,1844,257000
20,1434,1454,1434,0,1434,189000
52,400,816,833,897,1730,171500
0,626,626,626,591,1217,120000
0,1332,1332,1332,0,1332,145000
36,122,754,754,786,1540,184000
331,345,676,698,702,1400,162000
0,0,0,964,918,1882,160000
0,721,721,841,0,841,82000
0,784,784,784,0,784,76000
68,28,980,980,0,980,110000
560,420,980,980,0,980,135000
660,204,864,864,0,864,141000
864,0,864,864,0,864,122000
544,480,1024,1020,0,1020,124100
624,288,912,912,0,912,129000
594,270,864,1144,0,1144,131400
553,0,864,864,0,864,62383
140,182,912,912,0,912,123000
1733,189,2014,2014,0,2014,275000
601,158,975,975,780,1755,235000
0,1376,1376,1376,1629,3005,280750
0,612,612,612,612,1224,164500
294,318,612,612,612,1224,173733
0,1726,1726,1726,0,1726,222000
962,183,1145,1256,0,1256,195000
381,348,729,742,729,1471,172500
507,249,756,756,756,1512,180000
549,142,691,713,739,1452,156000
649,321,970,983,756,1739,172500
1252,306,1694,1694,0,1694,318750
960,266,1226,1226,0,1226,211500
121,1619,1740,1740,0,1740,241600
0,392,392,1487,1012,2499,180500
1116,165,1281,1620,0,1620,150000
298,429,727,829,727,1556,154000
0,1442,1442,1442,0,1442,185000
0,1489,1489,1489,0,1489,185750
859,216,1107,1107,983,2090,200000
560,150,752,1285,782,2067,206000
593,130,723,735,660,1395,162000
0,932,932,1271,1369,2640,256900
528,1152,1680,1724,0,1724,197900
553,588,1288,1336,0,1336,163000
955,261,1216,1216,0,1216,113000
432,476,908,1316,972,2288,230000
686,664,1350,1334,0,1334,167900
144,379,1650,1680,0,1680,213250
643,167,810,810,855,1665,227000
648,216,864,864,0,864,130000
0,1568,1568,1568,0,1568,143000
338,121,925,925,0,925,117500
698,467,1165,1165,896,2061,168500
962,270,1232,1320,0,1320,172500
251,491,1372,1342,0,1342,161500
734,160,894,894,0,894,141500
403,461,864,864,0,864,118000
612,252,864,864,0,864,127500
775,265,1040,1362,0,1362,140000
625,222,1048,1728,0,1728,177625
0,1584,1584,1776,0,1776,110000
196,975,1516,1516,0,1516,167000
310,491,1313,1313,0,1313,153000
998,294,1292,1292,0,1292,145100
740,184,1154,1154,0,1154,154000
388,356,744,825,1315,2140,177500
564,563,1127,1445,0,1445,158000
991,50,1041,1041,0,1041,124500
568,640,1208,1576,0,1576,174500
100,613,960,960,0,960,122000
280,140,420,708,0,708,82500
185,524,709,979,224,1203,110000
1024,481,1505,1505,0,1505,149500
1173,507,1680,1691,0,1691,175000
1285,131,1416,1644,0,1644,167000
504,546,1050,1050,0,1050,128900
120,736,856,1112,556,1668,140000
607,506,1113,1113,0,1113,147000
0,1584,1584,1584,0,1584,124000
1312,141,1453,1453,0,1453,187500
609,785,1394,1394,0,1394,159000
1387,175,1562,1567,0,1567,256000
454,314,768,1186,800,1986,205000
448,448,896,1182,960,2142,193500
0,1392,1392,1392,0,1392,110000
0,715,715,1281,457,1738,104900
856,313,1169,1144,0,1144,150000
189,628,1478,1478,0,1478,156500
544,785,1329,1329,0,1329,176000
708,280,988,988,0,988,149500
620,0,1240,1632,0,1632,139000
585,630,1215,1215,0,1215,155000
435,565,1202,1202,0,1202,120000
172,727,1382,1382,0,1382,153000
155,295,1200,1200,0,1200,144000
672,0,1362,1382,0,1382,176000
1213,84,1297,1297,0,1297,153000
0,1866,1866,1866,0,1866,135000
490,572,1062,1062,0,1062,131000
428,0,608,1319,0,1319,123000
308,323,631,1112,0,1112,126000
0,1005,1005,1005,0,1005,115000
650,178,1008,1363,0,1363,164900
700,93,793,793,0,793,113000
931,100,1031,1031,0,1031,145500
0,0,0,1210,0,1210,102900
440,538,978,1014,685,1699,95000
699,0,699,801,726,1527,152500
390,810,1200,1200,0,1200,129900
680,292,972,972,0,972,132000
0,792,792,792,0,792,99900
0,660,660,808,704,1656,135000
0,676,676,676,676,1352,149000
0,405,405,717,322,1039,114000
0,768,768,792,0,792,109500
0,1054,1054,1078,0,1078,125000
0,1313,1313,1313,0,2377,142900
0,560,560,930,760,1690,156500
0,416,416,599,0,599,59000
315,420,840,840,534,1374,105000
0,720,720,846,0,846,106000
0,630,630,725,0,725,78500
0,1248,1248,1248,1296,2544,190000
384,996,1380,1380,0,1380,154000
872,108,1040,1040,0,1040,163000
500,748,1248,1338,1296,2634,200000
745,206,951,951,0,951,143500
546,559,1105,1105,0,1105,135000
860,132,992,1306,0,1306,153000
1270,208,1478,1478,0,1478,157500
0,160,160,1142,0,1142,113500
375,457,832,1036,0,1268,133000
0,0,0,1040,0,1040,92900
621,174,795,765,368,1133,128500
0,0,0,1040,0,1040,90000
180,676,1208,1136,768,1904,138000
0,1041,1041,1041,0,1041,128000
504,525,1029,1339,0,1339,139000
630,0,732,732,0,732,118900
433,0,528,1183,0,1183,138000
1148,0,1148,1148,0,1148,132500
0,832,832,832,629,1461,133500
120,744,864,1064,0,1495,135000
0,780,780,993,813,1806,144750
941,0,941,941,0,941,145000
826,219,1045,1045,0,1045,127000
0,894,894,894,0,894,109500
468,350,818,818,406,1224,115000
0,440,440,682,548,1230,110000
0,901,901,861,517,1378,128900
633,339,972,972,972,1944,103500
0,676,676,676,455,1131,66500
0,240,240,810,496,1306,130000
0,504,504,764,700,1464,129000
421,269,690,868,690,1558,150000
0,994,994,1378,994,2372,107500
0,600,600,1101,600,1701,94550
0,960,960,960,1000,1960,124500
0,651,651,707,682,1389,135000
0,801,801,801,646,1447,103000
0,936,936,936,0,936,93000
384,384,768,768,560,1328,129500
0,811,811,811,576,1387,93000
0,861,861,861,0,861,80000
0,0,0,612,0,612,45000
0,600,600,600,368,968,37900
0,190,190,886,0,886,91300
0,624,624,792,0,792,99500
0,736,736,736,716,1452,113000
0,677,677,833,677,1510,87500
312,408,720,720,564,1284,110000
0,849,849,1075,1063,2138,106000
0,1240,1240,1320,1320,2640,265979
0,917,917,1090,917,2007,160000
0,624,624,664,624,1288,119000
216,700,916,916,826,1742,168000
0,624,624,816,0,816,58500
624,26,650,832,650,1482,143000
247,310,1022,1022,0,1022,85000
1088,0,1088,1188,561,1869,124900
0,972,972,1044,0,1480,119000
0,741,741,780,741,1521,146500
495,225,720,720,0,720,34900
0,245,245,797,0,797,44000
1309,15,1324,1072,504,1576,223500
0,1022,1022,1432,0,1432,149000
0,952,952,952,596,1548,205000
0,297,297,1001,653,1654,137000
0,952,952,952,0,952,121000
672,0,672,757,567,1324,128000
0,698,698,786,390,1176,134900
0,884,884,884,464,1348,117000
0,780,780,825,587,1412,132500
220,248,468,822,320,1142,93000
0,884,884,904,0,904,119000
405,740,1145,1301,0,1301,100000
0,927,927,1067,472,1539,141500
0,884,884,989,584,1573,133000
0,264,264,800,0,800,60000
209,506,715,875,0,875,105000
0,960,960,995,0,995,115000
273,679,952,994,588,1582,150000
134,938,1072,1072,0,1072,126500
0,844,844,1445,689,2134,214500
0,728,728,1136,883,2019,167500
0,1048,1048,1048,720,1768,155000
299,611,910,916,910,1826,155000
0,672,672,1272,672,1944,179900
0,755,755,929,929,2229,104000
0,1040,1040,1088,1040,2128,62500
522,198,720,1146,784,1930,149000
152,628,780,848,0,1208,103000
0,483,483,741,686,1427,123000
169,851,1020,978,886,1864,97500
0,1204,1204,1204,462,1666,135000
749,46,858,892,0,892,70000
276,160,698,754,649,1403,116000
0,560,560,704,0,704,88750
1200,0,1200,1200,0,1200,179000
1200,0,1200,1200,0,1200,179000
1152,0,1152,1152,0,1152,159900
350,333,683,904,0,904,61000
551,121,672,697,672,1369,103600
0,585,585,687,425,1112,63000
444,76,520,1464,0,1464,175000
651,470,1121,1121,0,1121,139000
226,192,918,918,765,1683,172500
527,525,1052,1052,0,1052,113500
450,414,864,899,0,899,130000
456,0,456,1034,0,1034,149900
685,173,858,858,0,858,134900
672,168,840,860,0,860,137000
170,252,1092,1092,0,1092,139000
0,552,552,904,611,1774,165000
588,550,1138,1138,0,1138,148000
0,825,825,2071,0,2071,165000
0,0,0,660,0,660,63900
0,1104,1104,1104,684,1788,161500
1324,113,1437,1473,0,1473,143000
1059,75,1134,1229,0,1229,135000
262,599,861,861,0,861,82500
379,470,1617,1867,0,1867,190000
0,0,0,1733,0,1733,139600
0,0,0,1383,0,1383,122000
0,1436,1436,1689,0,1689,127500
257,816,1073,1073,0,1073,121500
0,1276,1276,1276,0,1276,60000
342,405,747,892,747,1639,154400
344,328,672,672,0,672,113000
173,916,1089,1089,0,1089,125000
0,0,0,845,0,845,84000
552,104,1049,1049,0,1049,139500
292,476,768,1148,568,1716,131000
204,356,560,698,560,1258,105000
0,755,755,755,755,1510,108000
460,308,1054,1061,0,1061,162000
70,0,520,1338,0,1338,156500
1441,55,1496,1496,636,2132,316600
485,1496,2158,2196,0,2196,271900
513,227,740,1006,769,1775,213000
474,605,1079,1079,800,1879,239900
584,544,1128,1142,878,2020,239500
0,0,0,1288,728,2016,131000
0,0,0,1535,0,1535,118964
1086,0,1086,1224,0,1224,153337
0,0,0,1114,1114,2228,147983
0,0,0,1535,0,1535,118858
0,0,0,1535,0,1535,118858
0,0,0,1120,1120,2240,142953
1094,0,1094,1229,0,1229,148325
0,0,0,1513,0,1513,113722
820,348,1168,1168,1619,2787,269500
820,348,1168,1168,1619,2787,269500
820,348,1168,1168,1619,2787,269500
1021,534,1555,1680,0,1680,323262
1288,417,1705,1718,0,1718,297000
0,1622,1622,1630,0,1630,295493
1104,616,1720,1720,0,1720,332000
0,1468,1468,1468,0,1468,239900
20,846,866,866,902,1768,212000
1359,479,1838,1838,0,1838,272500
0,1800,1800,1800,0,1800,239000
1334,270,1604,1604,0,1604,220000
902,380,1282,1290,0,1290,200000
872,382,1254,1254,0,1254,221800
724,508,1232,1232,0,1232,194500
24,1474,1498,1498,0,1498,237000
0,704,704,704,718,1422,173000
1518,0,1518,1644,0,1644,275000
800,649,1449,944,815,1759,233500
249,0,1013,1160,966,2126,185000
732,308,1040,1040,0,1040,152000
755,235,990,990,0,990,143000
821,107,928,928,836,1764,231500
385,70,799,827,834,1661,212000
950,513,1463,1463,0,1463,207000
0,1097,1097,1097,0,1097,145000
746,244,990,990,0,990,138000
0,866,866,866,913,1779,197900
679,811,1490,1501,0,1501,204000
560,871,1431,1431,0,1431,192000
606,322,928,928,844,1772,200000
0,831,831,831,829,1660,195000
788,785,1573,1573,0,1573,227000
666,278,944,944,896,1840,230000
0,1413,1413,1430,0,1430,187100
1259,172,1431,1444,0,1444,203000
24,1468,1492,1492,0,1492,201000
616,424,1040,1040,0,1040,124000
625,282,907,907,0,907,140000
710,132,914,914,0,914,134900
532,364,1040,1040,0,1040,150500
646,218,864,864,0,864,136500
196,1072,1268,1268,0,1268,143500
460,404,864,864,0,864,133500
777,117,894,894,0,894,123000
660,108,768,768,0,768,133900
656,112,768,768,0,768,133000
1234,335,1569,1611,0,1611,250000
0,1068,1068,1068,1116,2184,254750
0,1753,1753,1788,0,1788,236500
990,309,1299,1299,573,1872,261500
904,536,1440,1476,677,2153,313000
0,840,840,840,885,1725,198500
0,944,944,944,926,1870,211000
1246,216,1462,1513,0,1513,220000
690,814,1504,1504,0,1504,203000
1360,462,1822,1828,0,1828,279500
1111,306,1417,1417,0,1417,210000
739,318,1057,1057,977,2034,219500
0,880,880,909,807,1716,191000
0,1212,1212,1212,0,1212,178000
0,1630,1630,1630,0,1630,213000
685,163,848,848,0,848,144000
685,163,848,848,0,848,140000
1478,100,1578,1602,0,1602,293200
0,864,864,864,864,1728,190000
20,1480,1500,1500,0,1500,190000
193,545,738,738,738,1476,173500
0,608,608,608,788,1396,170000
0,0,0,1126,0,1126,108000
637,849,1486,1486,0,1486,167000
690,126,816,816,0,816,100000
0,0,0,495,1427,1922,198500
535,155,690,698,728,1426,159500
399,615,1014,1149,0,1149,127000
631,410,1041,1125,0,1125,125000
1234,464,1698,1698,0,1698,320000
547,0,547,1072,0,1072,145500
0,698,698,698,0,698,118000
332,301,876,876,0,876,85000
1078,0,1078,1368,0,1368,120000
0,0,0,1088,441,1529,98000
0,864,864,864,0,864,99900
0,0,0,944,0,944,82000
0,1678,1678,1678,0,1678,119900
546,604,1150,1560,0,1560,103500
0,672,672,960,0,960,112000
0,684,684,684,512,1196,110000
626,94,720,854,444,1298,122000
408,156,984,984,620,1604,117000
832,0,832,832,436,1268,160000
182,611,793,848,672,1520,159434
290,0,290,438,0,438,60000
0,778,778,944,545,1489,139500
523,301,824,1687,998,3082,197000
0,583,583,647,595,1242,105000
622,500,1122,1328,653,1981,135000
0,816,816,1232,0,1232,147500
264,712,976,1160,448,1608,137450
350,0,560,575,560,1135,155000
0,896,896,1172,741,1913,177000
0,861,861,877,600,1477,145000
0,600,600,628,600,1228,137000
0,1276,1276,1276,804,2080,234000
728,112,840,840,727,1567,205000
547,224,771,753,741,1494,177500
428,300,728,976,332,1308,160000
793,480,1273,1273,0,1273,155000
713,163,876,964,0,964,163500
0,731,731,820,523,1343,154900
246,674,920,1240,1240,2480,205000
154,264,1112,1112,0,1112,144800
275,429,704,860,704,1564,174500
65,621,1561,1561,0,1561,193000
312,248,1067,986,537,1523,158000
0,1092,1092,1152,0,1152,158500
784,91,1310,1906,0,1906,224000
0,516,516,516,516,1032,115000
471,90,561,561,668,1229,137000
0,561,561,561,668,1229,121000
285,276,561,561,668,1229,124000
454,118,572,1182,800,1982,208000
803,581,1803,2365,0,2365,315000
808,72,880,1680,0,1680,222000
456,216,672,672,672,1344,147000
0,760,760,928,928,2168,123000
0,596,596,596,596,1192,78000
0,1013,1013,1013,0,1526,85000
0,572,572,572,0,572,75000
1476,120,1596,1648,0,1648,230000
0,0,0,810,0,810,57625
445,412,1107,1040,1012,2052,251000
1351,83,1434,1518,631,2149,239686
0,1710,1710,1710,0,1710,240000
690,114,804,804,1157,1961,215000
767,135,902,926,0,926,156450
841,0,957,1287,0,1287,173000
0,0,0,1302,432,1734,126000
611,577,1188,1217,0,1217,173000
55,1527,1582,1595,0,1595,152000
111,354,819,1344,0,1344,137500
1236,80,2136,2036,0,2036,375000
1022,598,1620,1620,0,1620,315500
0,846,846,846,846,1692,224500
1758,432,2190,2036,0,2036,410000
1115,526,1641,1641,0,1641,316500
16,1450,1466,1466,0,1466,201000
1005,387,1392,1412,0,1412,175000
462,250,712,1375,862,2237,204000
904,117,1645,1479,0,1479,213500
1005,262,1267,1296,0,1296,220000
0,912,912,1072,942,2014,170000
1260,578,1838,1838,0,1838,315000
1640,338,1978,1978,0,1978,425000
532,476,1008,1008,0,1008,139500
0,0,0,1771,0,1771,115000
866,338,1204,1204,0,1204,162000
883,341,1224,1224,0,1224,165000
462,0,462,526,462,988,91000
510,354,864,874,0,874,130000
515,115,630,630,0,630,86000
594,594,1188,1404,0,1404,160000
509,121,630,630,0,630,80000
0,546,546,798,546,1344,97000
273,0,546,546,546,1092,88000
720,0,796,796,0,796,131900
114,0,384,1091,0,1091,131250
1097,0,1097,1110,0,1110,165500
625,208,833,833,0,833,112000
718,0,828,883,0,883,149000
732,64,796,796,566,1362,143000
330,294,624,624,663,1287,130000
1567,0,1567,1567,0,1567,196000
496,0,784,784,848,1632,173000
528,245,1184,1414,0,1414,176500
865,340,1205,2117,0,2117,237500
500,176,952,1092,1020,2112,206900
706,220,926,926,678,1604,187500
476,204,680,680,790,1470,165000
851,75,926,926,678,1604,195500
828,115,943,943,695,1638,192000
138,778,916,916,720,1636,173000
450,898,1348,1384,0,1384,177900
604,125,729,729,717,1446,175000
1153,440,1593,1593,0,1593,286000
656,1008,1664,1682,0,1682,247900
733,604,1337,1337,0,1337,180000
0,1280,1280,1280,0,1280,180000
0,926,926,926,678,1604,181000
0,932,932,932,701,1633,183000
219,554,773,773,885,1658,188000
0,712,712,1086,809,1895,194500
504,332,836,851,858,1709,185000
767,461,1228,1228,0,1228,189000
319,1018,1337,1337,0,1337,188500
16,1152,1168,1168,1332,2500,355000
0,1122,1122,1134,1370,2504,325000
1337,547,1884,1884,0,1884,387000
0,1632,1632,1474,0,1474,115000
1034,676,1710,1710,0,1710,334000
0,1488,1488,1488,0,1488,133000
0,791,791,1236,857,2093,215000
983,692,1675,1688,0,1688,226500
588,606,1422,1422,0,1422,175500
747,513,1260,1260,0,1260,181900
1206,656,2048,2064,0,2064,235000
864,469,1782,1782,0,1782,220000
896,434,1330,1542,1330,2872,272000
890,273,1211,1211,0,1211,161000
767,266,1126,1126,0,1126,175000
0,738,738,1277,767,2044,185000
280,440,720,720,588,1308,146900
988,432,1420,1420,1420,2840,292500
644,549,1193,1523,0,1523,180000
0,1444,1444,1444,0,1444,159900
403,400,803,1098,866,1964,205000
1084,92,1176,1178,0,1178,157000
1023,213,1236,1236,1104,2340,306000
0,896,896,896,896,1792,133000
602,14,1054,1054,0,1054,151000
252,684,936,936,0,936,111900
119,132,864,864,0,864,123000
600,264,864,864,0,864,111250
266,1139,1405,1337,0,1337,181000
458,25,483,483,504,987,103400
330,153,483,483,504,987,100000
483,0,483,483,504,987,100500
321,162,483,483,504,987,106000
387,96,483,483,504,987,85400
358,125,483,483,504,987,89500
350,280,630,630,672,1302,111750
559,510,1069,1069,0,1069,140000
286,275,855,855,601,1456,143000
378,677,1055,1055,0,1055,148500
340,524,864,892,0,892,110000
1336,596,1932,1932,0,1932,394617
1280,402,1682,1742,590,2332,426000
1636,442,2078,2084,0,2084,385000
1330,122,1452,1476,1237,2713,446261
1012,570,1582,1582,0,1582,317500
1400,310,1710,1710,0,1710,372402
1728,195,2418,2464,0,2464,417500
1375,575,1950,1950,0,1950,383000
1420,430,1850,1850,898,2748,390000
1082,538,1620,1632,1158,2790,460000
1249,165,1414,1414,917,2331,379000
40,908,948,948,1140,2088,250000
856,292,1148,1170,1162,2332,316000
2257,278,2535,2470,0,2470,615000
1016,556,1572,1572,1096,2668,412500
866,132,998,1006,1040,2046,284000
1149,454,1603,1575,0,1575,284000
1075,404,1479,1515,1134,2649,421250
0,1765,1765,1804,886,2690,370000
372,1486,1858,1866,0,1866,336860
1540,162,1702,1702,0,1702,367294
20,1347,1367,1367,0,1367,192000
1218,300,1518,1518,0,1518,274000
28,1656,1684,1684,0,1684,266000
1204,596,1800,1800,0,1800,370967
846,496,1342,1342,0,1342,234250
24,1318,1342,1342,0,1342,219500
0,764,764,764,862,1626,155000
573,191,764,764,862,1626,154000
720,638,1358,1358,0,1358,207000
1073,342,1415,1455,0,1455,195000
1087,306,1393,1576,0,1576,219990
16,1330,1346,1504,0,1504,191000
0,1266,1266,1266,0,1266,159895
0,1146,1146,1246,0,1246,187687
0,789,789,813,702,1515,179000
759,80,839,864,729,1593,193000
655,201,856,1166,0,1166,190000
0,728,728,728,728,1456,176000
0,840,840,840,880,1720,188000
0,847,847,847,1139,1986,213000
876,474,1350,1358,0,1358,217300
0,936,936,962,830,1792,186500
544,438,982,1008,884,1892,226750
724,64,788,788,702,1490,184000
0,707,707,707,707,1414,176000
870,167,1037,1037,1285,2322,225000
0,831,831,873,778,1651,185900
0,1173,1173,1182,1017,2199,284500
986,484,1470,1470,1160,2630,315000
655,490,1145,1145,1053,2198,250000
0,1519,1519,1533,639,2172,291000
1660,322,1982,2006,0,2006,350000
851,213,1064,1064,1061,2125,279500
0,1242,1242,1251,1250,2501,290000
1696,413,2109,2113,0,2113,350000
1173,138,1311,1325,1093,2418,341000
228,0,1080,1108,1089,2197,287500
1000,223,1223,1223,904,2127,271000
1314,672,1986,1987,0,1987,301500
0,1580,1580,1580,0,1580,235128
0,894,894,894,1039,1933,214000
24,1550,1574,1574,0,1574,232000
1096,482,1578,1578,0,1578,240000
0,1498,1498,1506,0,1506,264132
33,1530,1563,1563,0,1563,245000
0,1417,1417,1428,0,1428,227680
0,1341,1341,1341,520,1861,257000
729,226,955,955,919,1874,297900
666,794,1460,1460,0,1460,247000
24,1339,1363,1372,0,1372,212700
0,1372,1372,1372,0,1372,250580
0,1428,1428,1428,0,1428,182000
400,466,866,866,902,1768,226700
0,1053,1053,1053,939,1992,250000
0,1026,1026,1026,932,1958,250000
789,245,1034,1050,1028,2078,339750
0,813,813,822,843,1665,205950
0,1660,1660,1660,0,1660,256000
902,316,1218,1218,0,1218,230348
503,361,864,864,864,1728,207500
680,400,1080,1080,0,1080,141000
80,200,835,835,861,1696,188000
0,835,835,835,828,1663,192500
80,1095,1175,1175,0,1175,146000
646,468,1114,1114,0,1114,159000
814,300,1114,1114,0,1114,155000
0,798,798,798,842,1640,173000
0,1162,1162,1162,0,1162,170000
362,392,754,754,855,1609,182000
602,284,886,886,794,1680,163000
1138,270,1408,1679,0,1679,193500
537,295,832,832,825,1657,189000
472,355,827,827,850,1677,190500
397,439,836,844,893,1737,175000
1200,78,1278,1294,0,1294,179200
426,406,832,832,878,1710,187000
165,598,1604,1617,0,1617,193000
300,899,1199,1199,0,1199,153900
53,132,984,984,0,984,128000
737,175,912,912,0,912,144000
764,100,864,864,0,864,135000
890,0,890,890,0,890,115000
489,375,864,864,0,864,119916
832,80,912,912,0,912,142000
800,630,1430,1430,0,1430,192000
190,0,1001,1001,640,1641,140000
704,226,930,1364,1319,2683,290000
520,1328,1848,1827,959,2786,372500
16,1375,1391,1391,0,1391,196000
0,625,625,625,625,1250,171900
24,1211,1235,1245,0,1245,178000
390,210,600,600,600,1200,165000
0,689,689,703,689,1392,146000
0,689,689,703,689,1392,146000
549,195,744,757,744,1501,179400
550,194,744,757,792,1549,172900
1027,587,1614,1638,0,1638,300000
1004,306,1310,1310,0,1310,285000
964,455,1419,1419,0,1419,290000
1141,416,1557,1557,0,1557,305000
1238,460,1698,1709,0,1709,328900
510,90,600,624,628,1252,160000
600,72,672,684,720,1404,170000
681,177,858,872,917,1789,223000
612,348,960,962,624,1586,170000
813,147,960,962,645,1607,200000
128,0,970,1469,924,2393,345000
786,474,1260,1288,0,1288,245500
560,0,1230,1239,0,1239,217500
1619,100,1719,1719,0,1719,324000
660,572,1232,1232,0,1232,162500
410,584,994,1599,1345,2944,150000
1044,0,1426,1671,0,1671,290000
0,952,952,952,860,1812,205000
0,1304,1304,1682,0,1682,174000
828,599,1427,1427,0,1427,183000
301,1439,1740,1740,0,1740,150000
656,602,1258,1258,0,1258,145000
603,723,1620,1620,0,1620,215000
0,1625,1625,1625,0,1625,140500
956,384,1522,1548,1066,2614,240000
732,0,732,732,732,1464,141000
595,317,912,912,0,912,147000
260,196,912,925,0,925,135000
0,1728,1728,1728,0,1728,145000
231,1497,1728,1728,0,1728,142600
0,1656,1656,1656,0,1656,135000
583,242,825,845,825,1670,170000
575,487,1142,1175,1540,2715,299800
442,459,901,943,933,1876,185000
400,336,800,800,832,1632,173000
867,77,944,999,0,999,178400
552,280,832,1098,880,1978,176000
0,0,0,1014,0,1014,98000
288,619,907,907,0,907,109008
228,724,952,952,0,952,135750
776,344,1120,1128,0,1128,155000
490,935,1425,1425,0,1425,180500
312,276,1127,1165,0,1165,174900
892,244,1136,1136,0,1136,140000
787,305,1092,1092,0,1092,145000
633,586,1219,1265,0,1265,179900
624,288,1248,1350,0,1350,168500
0,1114,1114,1114,0,1114,140000
806,247,1053,1053,0,1053,145500
0,1252,1252,1252,0,1252,142000
419,375,1100,1100,0,1100,141000
528,590,1118,1118,0,1118,153000
0,0,0,720,0,720,72500
0,270,270,729,0,729,52000
851,140,991,1077,0,1077,118000
120,228,348,453,453,906,87000
658,638,1296,1496,0,1496,141500
280,752,1032,1032,220,1252,119000
32,232,572,1337,0,1337,141500
831,161,992,1661,0,1661,165500
531,505,1036,1036,0,1036,112900
454,410,864,902,918,1820,201800
288,700,1362,1362,0,1362,163000
572,572,1144,1144,0,1144,139950
0,1319,1319,1537,0,1537,174000
371,728,1099,1431,0,1431,165000
575,529,1104,1104,884,1988,227000
902,196,1098,1098,0,1098,135000
25,247,1144,1144,0,1144,124000
504,319,931,1283,0,1283,140000
621,503,1176,1176,0,1176,136500
1053,195,1248,1440,0,1440,185000
662,599,1261,1261,0,1261,163000
958,437,1395,1570,0,1570,166800
616,580,1196,1196,0,1196,139000
1040,352,1392,1392,0,1392,166000
570,510,1080,1080,0,1080,136000
774,330,1104,1104,0,1104,133000
148,572,720,882,0,882,116000
500,456,1152,1152,0,1152,137500
624,232,984,950,0,950,130000
0,998,998,1790,0,1790,180000
852,100,952,952,0,952,139000
570,203,773,773,0,773,110000
0,0,0,1764,0,1764,100000
442,390,832,832,384,1216,118500
0,1824,1824,1824,0,1824,146000
0,0,0,869,0,869,89900
0,747,747,747,412,1159,114000
580,333,913,1048,510,1558,140000
0,672,672,672,0,672,86900
0,892,892,1254,182,1436,139000
0,0,0,694,600,1294,106250
319,539,858,858,858,1716,171000
744,168,912,1044,0,1044,139000
637,675,1312,1312,0,1312,186000
733,520,1253,1253,0,1253,157000
697,384,1081,1081,0,1081,148000
425,160,585,2069,0,2069,242000
0,105,105,910,0,910,116000
432,444,876,876,0,876,94000
0,0,0,1048,0,1048,98300
666,409,1075,1507,0,1507,127000
476,292,1256,1256,0,1256,159000
520,188,1027,1027,0,1027,125900
374,363,1269,1269,0,1269,155000
315,453,768,819,501,1320,138000
0,936,936,984,0,984,112500
0,832,832,832,0,832,105500
673,181,854,854,424,1278,127500
0,1800,1800,1800,0,1800,130000
370,398,768,1024,564,1588,150000
0,825,825,825,0,825,109500
400,380,780,983,813,1796,140000
674,0,780,798,813,1611,167900
0,1117,1117,1117,0,1117,136870
96,96,192,1133,0,1133,143000
0,680,680,764,0,764,73000
0,650,650,958,581,1539,157500
0,780,780,948,375,1323,122600
0,680,680,680,680,1360,111000
493,1017,1510,1584,1208,2792,256000
0,672,672,672,0,672,64000
0,728,728,728,728,1456,139500
0,828,828,828,658,1594,118000
0,1362,1362,1362,720,2082,200000
0,801,801,1095,561,1656,119164
360,576,936,960,780,1740,122250
0,931,931,1027,0,1027,120000
590,294,884,884,552,1436,155000
0,481,481,899,0,899,78000
0,684,684,684,396,1080,95000
104,516,789,789,0,789,115000
144,172,924,1122,0,1122,147000
445,459,904,904,595,1499,140000
0,407,407,407,0,407,46500
308,620,928,928,0,928,112500
0,901,901,901,0,901,107900
0,448,448,1588,0,1588,65000
0,1470,1470,1675,1818,3493,295000
0,797,797,830,797,1627,139500
0,876,876,876,540,1416,153900
116,508,624,730,720,1450,132000
0,624,624,624,720,1344,98000
0,346,346,709,308,1017,114000
234,739,973,1377,973,2350,130000
319,416,735,1134,924,2058,129500
0,572,572,884,656,1540,129400
141,548,689,689,689,1378,161000
0,482,482,1221,691,1912,163000
0,742,742,742,742,1484,128000
259,425,684,938,1215,2358,122000
0,572,572,572,539,1111,116900
0,1237,1237,1521,1254,2775,325000
0,723,723,723,363,1086,55000
0,1313,1313,1313,1182,2495,184000
200,784,984,984,0,984,110000
0,1050,1050,1050,745,1795,131500
0,0,0,882,0,882,97000
0,869,869,1093,0,1093,115500
406,329,1008,1143,0,1143,138000
0,672,672,1195,473,1668,108000
0,742,742,779,0,935,79500
175,849,1024,1144,594,1738,153000
784,0,784,784,0,784,109500
600,72,672,832,378,1210,124000
0,554,554,736,554,1290,106900
521,460,981,1014,658,1672,164900
0,949,949,949,0,949,119000
0,862,862,950,208,1158,120000
201,462,825,825,672,1497,157000
264,475,739,874,468,1342,105000
0,992,992,1013,0,1013,113000
68,497,565,565,651,1216,115000
,,,896,0,896,79000
80,624,704,624,512,1136,123000
0,0,0,808,0,808,81300
0,1078,1078,1128,445,1573,162900
300,449,989,1245,764,2009,150000
203,897,1100,1226,676,1902,123500
0,952,952,1022,752,1774,129900
0,611,611,751,611,1362,128000
0,520,520,520,0,520,68500
336,295,672,1072,213,1285,127000
0,833,833,1053,795,1848,207000
329,697,1026,1133,687,1820,184000
0,810,810,1170,546,1716,162500
399,484,883,988,517,1505,145000
210,0,816,838,0,838,130000
196,1046,1242,1242,742,1984,160000
0,588,588,833,833,1666,161000
0,796,796,825,784,1609,127500
0,768,768,768,0,768,93850
372,396,768,768,768,1536,136000
0,1272,1272,1272,0,1969,141000
0,880,880,880,428,1308,120000
0,1040,1040,1040,0,1040,127500
121,647,768,788,448,1236,127000
0,319,319,1035,371,1406,89500
180,0,825,825,0,825,125000
0,901,901,1088,110,1198,79900
0,451,451,759,0,759,85000
0,536,536,808,536,1344,82375
0,756,756,756,713,1469,135000
0,1046,1046,1054,0,1054,124000
250,210,952,1211,0,1211,134000
0,720,720,720,551,1271,135000
0,0,0,1120,468,1588,134432
351,112,644,808,547,1355,127500
784,197,981,1075,0,1075,148000
906,134,1040,1040,0,1040,129500
528,480,1008,1096,0,1096,157500
0,876,876,904,0,904,109900
758,234,992,992,0,992,145000
702,192,894,894,0,894,130000
450,0,450,1034,0,1034,153000
221,852,1073,1073,0,1073,120000
104,0,1060,1126,0,1126,152000
1198,0,1198,1258,0,1258,108959
1300,0,1300,1140,0,1140,95541
288,718,1006,1006,0,1006,80000
0,1228,1228,1228,0,1228,149350
634,326,960,960,0,960,144900
776,212,988,1188,0,1188,185000
1064,319,1383,1383,0,1383,165000
429,93,1602,1252,0,1252,235000
0,533,533,1021,580,1601,140000
0,672,672,672,0,672,108000
988,0,988,1721,0,1721,145000
336,240,576,864,486,1350,152400
704,160,864,904,0,904,144000
1003,288,1291,1291,0,1291,173000
392,768,1160,1156,866,2022,192000
599,925,1524,1524,0,1524,245000
226,96,1385,1363,0,1363,241500
1116,248,1364,1663,0,1663,256000
719,300,1019,1357,0,1357,177000
0,570,570,617,462,1079,125600
500,594,1094,1094,0,1094,155000
0,907,907,1307,1051,2358,240000
1035,545,1580,1518,0,1518,260000
0,1163,1163,1163,511,1674,185000
626,501,1127,1236,872,2108,235000
870,639,1509,1509,0,1509,159900
864,0,864,864,0,864,99600
324,297,621,621,648,1269,134500
241,229,861,961,406,1367,119000
969,148,1117,820,527,1347,107500
1040,124,1164,1164,0,1164,125000
0,572,572,572,524,1096,79000
236,0,616,616,495,1111,95000
1085,390,1475,1532,797,2329,262280
779,298,1077,1093,1721,2814,260000
1271,331,1602,1626,0,1626,226500
355,457,812,1101,1099,2200,225000
0,672,672,1302,735,2037,229000
0,628,628,628,728,1356,177439
0,1615,1615,1615,0,1615,248500
2085,186,2271,2276,0,2276,475000
1153,598,1751,1766,0,1766,395039
50,499,1080,1080,1017,2097,228000
770,631,1401,1511,0,1511,225000
262,197,1182,1643,0,1643,195000
462,154,616,616,1072,1688,200000
722,268,990,990,0,990,155000
0,1099,1099,1099,0,1099,144000
686,304,990,990,0,990,145000
1308,110,1418,1418,0,1418,226001
688,176,864,872,899,1771,215700
527,255,782,782,870,1652,207500
633,240,873,882,908,1790,193000
0,880,880,880,844,1724,188000
0,1468,1468,1479,0,1479,191000
922,572,1494,1494,0,1494,221000
361,602,963,963,829,1792,231500
663,265,928,928,895,1823,235000
486,434,920,920,866,1786,223500
280,167,938,938,0,938,130250
595,390,985,985,0,985,149900
781,83,864,1174,0,1174,158000
505,0,940,1026,0,1026,147000
294,782,1076,1076,0,1076,143195
88,180,864,1558,0,1558,163000
0,924,924,924,0,924,110000
390,474,864,864,0,864,127000
632,148,780,780,0,780,124900
0,1777,1777,1795,0,1795,230000
804,324,1128,1128,903,2031,237000
735,257,992,992,873,1865,235000
0,1257,1257,1290,871,2161,230500
668,336,1004,1004,848,1852,230000
252,901,1153,1153,878,2031,222500
0,1055,1055,1055,1208,2263,287000
1194,163,1357,1366,581,1947,274000
1538,240,1778,1786,0,1786,300000
0,1128,1128,1149,1141,2290,255900
550,334,884,884,884,1768,224900
0,1129,1129,1129,1198,2327,240000
0,798,798,798,842,1640,183000
0,850,850,886,878,1764,207000
642,273,915,933,975,1908,210000
686,162,848,848,0,848,136500
662,186,848,848,0,848,145000
994,484,1478,1493,0,1493,208900
1593,83,1838,1838,0,1838,185000
810,726,1536,1536,0,1536,214000
706,150,856,856,854,1710,208500
24,1421,1445,1445,0,1445,186500
946,490,1436,1436,0,1436,210000
490,280,770,770,812,1582,185900
0,1234,1234,1234,0,1234,179900
56,1508,1564,1564,0,1564,218836
24,1327,1351,1361,0,1361,193000
648,80,728,728,728,1456,189000
697,151,848,848,0,848,149300
697,151,848,848,0,848,141000
662,186,848,848,0,848,149000
662,186,848,848,0,848,144500
0,796,796,796,0,796,85000
1084,188,1272,1272,928,2200,145900
609,483,1092,1092,0,1092,123000
830,136,1256,1256,0,1256,147500
456,0,456,1033,0,1033,165000
1033,94,1127,1127,0,1127,135000
290,706,996,996,0,996,108000
920,38,1138,1181,0,1181,137500
0,746,746,760,896,1656,165400
368,541,1029,1117,0,1117,147000
288,396,684,684,714,1398,160500
1024,108,1132,1132,0,1132,176000
0,0,0,3820,0,3820,284700
5644,466,6110,4692,950,5642,160000
459,88,547,1072,0,1072,148000
0,0,0,1152,0,1152,82000
0,0,0,1152,0,1152,82000
133,1307,1440,1440,0,1440,118000
0,0,0,1152,0,1152,82500
784,0,784,784,0,784,91900
0,585,585,585,468,1053,120000
0,0,0,929,208,1137,96000
767,144,911,930,0,930,99000
352,416,768,768,432,1200,130500
0,941,941,997,473,1470,135000
0,816,816,872,521,1393,135500
0,416,416,1204,0,1204,100000
224,725,949,949,343,1292,108000
468,396,864,864,0,864,98000
41,823,864,864,0,864,67000
210,570,780,936,780,1716,135900
156,516,672,810,672,1482,140000
378,342,720,1052,720,2192,179500
423,758,1181,1390,304,1694,136500
0,1228,1228,1424,0,1424,168000
0,940,940,1024,940,1964,130000
0,612,612,990,1611,2601,189000
281,0,960,960,960,1920,161900
379,265,644,672,644,1316,145000
0,588,588,1423,748,2555,191000
0,840,840,840,840,1680,177000
0,676,676,676,588,1264,147500
384,384,768,790,0,790,91000
406,392,798,798,714,1512,231000
0,1064,1064,1166,0,1639,115000
0,784,784,819,784,1603,138000
0,776,776,851,651,1502,149000
326,389,715,849,811,1660,188700
606,336,942,1265,673,1938,198000
0,884,884,932,442,1374,110000
500,591,1091,1091,0,1091,104000
210,398,608,983,890,1873,257076
192,536,728,1968,1479,3447,381000
341,457,798,1137,817,1954,311500
435,397,832,1218,943,2161,263400
1116,782,1898,1898,0,1898,236500
728,568,1296,1640,0,1640,224000
366,150,516,516,516,1032,116500
81,23,716,716,840,1556,151000
299,555,894,919,0,919,126000
0,720,720,760,330,1090,120000
0,796,796,796,0,796,55000
538,278,816,816,0,816,120500
403,212,740,778,0,778,120500
0,780,780,780,420,1200,119000
257,367,624,1092,564,1656,126000
0,520,520,912,0,912,99500
330,821,1151,1151,804,1955,165500
0,0,0,733,0,733,13100
0,173,173,825,536,1361,89000
0,649,649,649,668,1317,40000
0,356,356,671,378,1049,80900
0,894,894,894,0,894,81000
0,592,592,432,432,864,65000
1480,120,1600,1652,0,1652,392500
1476,120,1596,1648,0,1648,294464
1474,120,1594,1646,0,1646,250000
1373,221,1594,1646,0,1646,275000
700,1140,1840,2032,0,2032,300000
1218,350,1568,1689,0,1689,271000
0,910,910,910,910,1820,213000
522,574,1096,1118,0,1118,171000
641,276,1196,1279,0,1279,171500
0,0,0,936,936,1872,100000
1383,297,1680,1689,0,1689,228500
1249,103,1499,1619,167,1786,228950
893,384,1277,1501,0,1501,241500
1165,0,1565,2898,0,2898,287000
1036,482,1518,1537,0,1537,294000
1513,125,1638,1646,0,1646,293077
770,150,920,920,860,1780,264966
0,352,352,712,730,1442,172500
0,384,384,754,640,1394,167500
0,796,796,796,816,1612,218689
0,1495,1495,1495,0,1495,150000
1398,0,1606,1651,0,1651,184000
920,276,1256,1256,0,1256,180000
783,678,1461,1509,0,1509,175000
1029,403,1432,1440,0,1440,232500
1223,443,1666,1675,0,1675,195000
871,611,1482,1482,780,2262,305000
1011,873,1884,1728,0,1728,298751
1571,393,1964,1964,0,1964,370000
1309,35,1344,1344,0,1344,209200
1309,35,1344,1344,0,1344,206300
0,1092,1092,1092,0,1092,146000
864,325,1189,1189,0,1189,160500
865,88,1200,1200,0,1200,173000
769,271,1040,1040,0,1040,124000
0,264,264,616,688,1304,115000
318,232,550,925,550,1475,129500
501,25,526,526,462,988,105000
437,25,462,526,462,988,94900
785,328,1113,1160,0,1160,152500
358,188,546,546,546,1092,98000
495,135,630,630,0,630,81000
0,988,988,988,0,988,113000
534,282,816,816,0,816,128500
658,218,876,923,0,923,119500
641,175,816,816,0,816,130500
816,0,816,816,0,816,138000
638,207,845,845,0,845,134500
660,323,983,983,767,1750,160000
647,217,864,889,0,889,137500
562,29,784,1168,800,1968,172000
0,686,686,1150,686,1836,103000
838,749,1587,1587,0,1587,167300
778,499,1277,1277,0,1277,167000
1880,343,2223,2223,0,2223,244000
351,1043,2217,2217,0,2217,268000
0,847,847,847,886,1733,225000
0,806,806,806,766,1572,168000
182,612,794,794,676,1470,177000
0,916,916,916,684,1600,169000
0,384,384,754,630,1384,161500
1196,298,1494,1652,0,1652,251000
186,206,392,924,770,1694,160000
871,52,923,947,767,1714,180000
414,277,691,691,862,1553,178750
0,1237,1237,1253,0,1253,176000
0,938,938,957,1342,2299,204000
0,1168,1168,1187,0,1187,160000
0,384,384,802,670,1472,160000
0,384,384,812,670,1482,163900
0,903,903,910,732,1642,168000
550,752,1302,1128,0,1128,154204
0,1074,1074,1088,0,1088,170000
828,180,1190,1190,900,2090,207500
248,918,1166,1179,0,1179,182000
926,386,1312,1321,0,1321,212000
1249,673,1922,1922,0,1922,377426
986,163,1149,1164,1377,2541,349265
1101,1559,2660,2338,0,2338,591587
1047,53,1100,1424,0,1424,155000
797,815,1612,1612,0,1612,319900
945,474,1419,1419,0,1419,392000
1558,662,2220,2234,0,2234,441929
1152,590,1742,2042,0,2042,455000
678,762,1440,1440,0,1440,182900
256,1028,1284,1284,0,1284,174000
0,585,585,1140,728,1868,178000
321,404,725,725,754,1479,176000
1328,201,1529,1664,0,1664,213000
758,22,780,1085,845,1930,192000
0,808,808,1161,808,1969,190000
156,692,848,1118,912,2030,195000
605,427,1032,1032,0,1032,148000
781,372,1153,1177,0,1177,151500
315,114,539,1040,685,1725,197000
903,356,1259,1353,0,1353,192350
493,0,780,780,840,1620,152000
492,1012,1625,1220,0,1220,170000
998,486,1484,1484,0,1484,175000
384,143,702,1041,702,1743,175000
0,793,793,1142,793,1935,197900
624,0,1228,1324,0,1324,174000
931,0,1084,1084,793,1877,178900
349,23,372,576,533,1109,139000
282,664,981,981,0,981,143250
626,99,725,725,754,1479,184000
566,359,925,1422,0,1422,155000
81,214,914,914,0,914,133000
412,251,950,950,0,950,119500
0,858,858,872,0,872,123000
322,536,858,858,0,858,110000
314,600,914,914,0,914,128000
616,248,864,864,0,864,120500
584,0,723,767,0,767,133000
0,1337,1337,1337,0,1337,155000
930,475,1405,1337,0,1337,177000
312,213,525,525,567,1092,113500
356,316,672,672,546,1218,113000
0,672,672,672,546,1218,113700
0,630,630,630,672,1302,106000
471,294,765,765,600,1365,122500
120,958,1078,958,0,958,128000
556,248,804,804,744,1548,155000
632,423,1061,1055,0,1055,142500
725,263,988,988,0,988,129250
1151,639,1790,1816,0,1816,356000
48,1774,1822,1828,0,1828,314813
0,1694,1694,1694,0,1694,318000
0,1694,1694,1694,0,1694,322400
1004,730,1734,1734,0,1734,318000
1518,590,2108,2122,0,2122,345474
0,2121,2121,2121,0,2121,415298
1304,630,1934,1943,713,2656,492000
0,1108,1108,1148,1402,2550,338931
1430,564,1994,2046,0,2046,450000
0,1063,1063,1071,1101,2172,280000
1812,740,2552,2552,0,2552,479069
0,1935,1935,1973,0,1973,395000
0,2153,2153,2069,574,2643,380000
0,1626,1626,1634,0,1634,250000
1350,626,1976,1976,0,1976,440000
0,1704,1704,1722,1036,2758,418000
1684,636,2320,2290,0,2290,500067
0,1582,1582,1582,570,2152,260116
0,1143,1143,1143,1330,2473,317000
778,140,918,958,1142,2100,319500
1288,294,1582,1610,551,2161,325624
0,1802,1802,1802,0,1802,372000
0,1706,1706,1718,1238,2956,342000
970,166,1136,1136,1332,2468,354000
938,379,1317,1217,1168,2385,350000
0,1181,1181,1234,1140,2374,285000
669,226,895,895,923,1818,281500
1178,436,1614,1614,0,1614,245700
119,1602,1721,1721,0,1721,232698
0,1298,1298,1298,530,1828,250000
20,1342,1362,1362,0,1362,194700
866,436,1302,1302,0,1302,204000
1030,272,1302,1302,0,1302,200000
762,600,1362,1362,0,1362,207000
24,1530,1554,1554,0,1554,209500
24,1530,1554,1554,0,1554,209500
24,1346,1370,1370,0,1370,202500
848,729,1577,1577,0,1577,280000
1153,408,1561,1561,0,1561,277500
0,1869,1869,1869,0,1869,318061
24,1300,1324,1324,0,1324,221370
1000,405,1405,1405,0,1405,200000
0,768,768,768,728,1496,181755
0,768,768,768,768,1536,176000
0,783,783,783,701,1484,178900
0,608,608,608,850,1458,168165
0,738,738,738,757,1495,171925
0,698,698,698,1048,1746,198444
918,408,1326,1326,0,1326,203000
0,728,728,728,728,1456,179540
0,1302,1302,1302,0,1302,176485
24,1316,1340,1340,0,1340,181134
0,616,616,616,796,1412,156932
0,752,752,752,752,1504,166000
0,728,728,728,728,1456,177594
0,1246,1246,1258,0,1258,173500
0,1258,1258,1258,0,1258,172500
0,1258,1258,1402,0,1402,194201
1084,322,1406,1589,0,1589,226500
0,1266,1266,1266,0,1266,185485
1300,230,1530,1530,0,1530,259000
779,56,835,1119,0,1119,188500
192,192,384,744,630,1374,175000
0,847,847,847,1112,1959,215000
0,1510,1510,1525,0,1525,206580
0,840,840,840,880,1720,183500
0,384,384,754,640,1394,165500
0,847,847,847,1101,1948,211000
0,924,924,948,742,1690,181000
574,280,854,864,1131,1995,219500
0,953,953,953,694,1647,175000
0,384,384,774,656,1430,170000
0,660,660,660,660,1320,162000
520,395,915,940,750,1690,187000
0,941,941,961,683,1644,185000
2096,300,2396,2411,2065,4476,745000
1181,598,1779,1779,772,2551,384500
0,969,969,997,1288,2285,248000
1282,1351,2633,2633,0,2633,466500
672,736,1408,1671,1407,3078,410000
1048,341,1389,1411,1171,2582,322500
0,1066,1066,1108,1277,2385,252000
1455,989,2444,2444,1872,4316,755000
862,255,1117,1127,886,2013,269790
719,660,1379,1383,1015,2398,315750
565,638,1203,1214,1306,2520,290000
56,1198,1318,1328,1203,2531,290000
1231,1969,3200,3228,0,3228,430000
335,770,1105,1105,1097,2202,263000
1225,100,1325,1335,1203,2538,330000
0,1369,1369,1369,0,1369,213133
1220,322,1542,1542,0,1542,260261
0,1905,1905,1905,0,1905,320000
929,556,1485,1464,0,1464,282922
28,1496,1524,1534,0,1534,215000
1572,394,1966,1966,0,1966,419005
63,1560,1623,1636,0,1636,255000
0,1795,1795,1795,0,1795,147000
0,1528,1528,1528,0,1528,235876
1126,600,1726,1726,0,1726,311872
0,1689,1689,1689,0,1689,248328
0,1588,1588,1588,0,1588,227000
769,769,1538,1538,0,1538,260000
0,1496,1496,1496,0,1496,225000
778,716,1494,1506,0,1506,249000
1369,317,1686,1694,0,1694,307000
0,982,982,982,995,1977,250000
0,1302,1302,1302,528,1830,221300
24,1314,1338,1338,0,1338,208900
0,1335,1335,1335,0,1335,210400
350,546,896,896,896,1792,255000
0,725,725,725,863,1588,212109
0,1088,1088,1088,871,1959,270000
64,1120,1184,1184,1426,2610,303477
745,210,955,955,925,1880,310013
24,1632,1656,1656,0,1656,249700
0,874,874,874,887,1761,227875
0,1574,1574,1584,0,1584,261329
0,1685,1685,1685,0,1685,253000
0,1158,1158,1158,1285,2443,265000
0,1580,1580,1580,886,2466,340000
0,1100,1100,1100,0,1100,146000
0,1143,1143,1143,0,1143,147000
729,365,1094,1094,0,1094,149000
0,1461,1461,1486,0,1486,181000
814,114,928,936,785,1721,201000
480,384,864,920,900,1820,191750
0,1349,1349,1349,0,1349,179000
1443,39,1482,1494,0,1494,215000
430,1145,1575,1575,0,1575,179200
0,630,630,630,636,1266,128000
747,0,840,884,0,884,144000
0,0,0,2020,0,2020,144000
138,405,894,894,0,894,120750
630,340,970,970,0,970,132500
417,640,1057,1057,0,1057,132000
588,411,999,999,0,999,132500
932,108,1040,1120,0,1120,129000
0,1140,1140,1696,0,1696,143900
812,228,1040,1040,0,1040,145000
827,161,988,988,0,988,128500
599,277,876,902,0,902,125500
727,496,1223,1271,1232,2503,300000
125,36,1192,1516,651,2167,294000
787,250,1037,1037,0,1037,129000
1390,0,1390,1701,0,1701,171000
968,76,1044,1055,0,1055,147000
482,971,1453,1453,1357,2810,302000
700,983,1683,2129,743,2872,285000
851,527,1378,1378,0,1378,214000
60,1081,1141,1151,0,1151,166000
60,1451,1511,1565,0,1565,193800
0,1352,1352,1352,0,1352,208900
937,415,1352,1352,0,1352,194000
0,1550,1550,1550,0,1550,207500
1106,135,1241,1241,0,1241,199900
0,625,625,625,625,1250,164700
565,179,744,757,744,1501,176500
419,310,729,729,729,1458,176000
420,336,756,756,756,1512,168500
417,339,756,769,804,1573,177000
436,320,756,769,756,1525,177000
239,312,551,551,551,1102,148800
0,776,776,764,677,1441,174000
649,326,975,975,975,1950,239000
0,1339,1339,1358,0,1358,204000
964,90,1054,1072,976,2048,301000
901,319,1220,1220,1142,2362,312500
457,0,1494,1494,0,1494,279700
1732,270,2002,2362,0,2362,255000
680,289,1360,1432,0,1432,194000
1157,280,1437,1437,0,1437,218000
881,0,1057,1295,0,1295,213750
0,528,528,1094,761,1855,187000
978,284,1262,1262,0,1262,181500
1632,0,2461,2497,0,2497,373000
498,652,1361,1361,1259,2620,190000
738,319,1057,1057,872,1929,226000
0,912,912,1152,0,1152,143450
915,93,1008,1403,1008,2411,240050
973,0,973,1082,0,1082,162500
910,385,1295,1295,0,1295,164000
346,778,1124,1610,0,1610,185000
0,1594,1594,1594,0,1594,188500
819,329,1148,1091,984,2075,255000
0,1680,1680,1680,0,1680,136905
792,301,1093,1093,0,1093,158500
916,326,1242,1242,0,1242,175500
617,171,1052,1052,0,1052,127000
474,437,949,1107,0,1107,127000
695,519,1214,1214,0,1214,143000
836,237,1073,1073,0,1073,156000
457,193,1024,1344,0,1344,144000
40,1424,1728,1728,0,1728,119000
0,0,0,1224,0,1224,103000
0,978,978,1422,0,1422,139900
498,460,958,958,0,958,151500
0,1065,1065,1065,0,1065,126500
507,81,588,1138,0,1138,145000
111,522,912,912,0,912,120000
438,250,894,1074,0,1074,124000
0,0,0,882,0,882,106500
311,386,864,1187,0,1187,140500
700,264,964,964,0,964,137500
0,894,894,894,0,894,117600
654,520,1174,1200,0,1200,163500
494,548,1042,1042,0,1042,161000
270,452,1302,1302,0,1302,158000
414,431,845,845,1309,2154,224500
54,533,1130,1374,0,1374,147000
1386,206,1592,1652,0,1652,200000
594,331,1144,1429,0,1429,181900
405,658,1063,1327,0,1327,150750
0,0,0,1224,0,1224,101800
0,932,932,932,0,932,124000
130,433,822,908,0,908,138500
0,0,0,334,0,334,39300
299,367,666,666,0,666,64500
144,226,370,442,228,670,64000
150,254,808,808,0,808,112000
442,374,816,1127,850,1977,165000
368,710,1078,1150,0,1150,144000
220,708,928,928,992,1920,137000
368,359,768,968,408,1376,105000
386,342,728,888,756,1644,146500
0,1560,1560,1560,0,1560,126000
602,191,793,1280,0,1280,175000
600,618,1218,1254,0,1254,158500
456,456,912,912,0,912,114500
460,414,874,874,650,1524,144000
187,111,1021,1465,915,2380,129000
873,63,936,936,0,936,141000
908,100,1008,1008,0,1008,131000
288,765,1053,1053,0,1053,142100
846,210,1056,1056,0,1056,139000
608,834,1442,1442,0,1442,157900
480,108,1056,1056,0,1056,139400
777,467,1244,1244,0,1244,150000
0,1144,1144,1144,0,1144,120000
668,525,1331,1721,0,1721,174850
512,410,922,922,0,922,116000
586,462,1048,1048,0,1048,135000
1237,420,1657,1657,0,1657,163500
780,424,1204,1411,0,1411,130000
288,928,1216,1216,0,1216,129500
408,456,864,1154,0,1154,142000
0,1560,1560,1560,0,1560,128600
441,507,948,948,0,948,125000
85,0,1040,1040,0,1040,136000
643,365,1008,1008,0,1008,134500
114,120,925,925,0,925,127000
384,0,384,1360,0,1360,130000
150,1040,1190,1040,500,1540,115000
793,130,923,925,0,925,116900
377,551,928,928,0,928,132000
595,156,1105,1647,0,1647,153000
292,632,924,924,0,924,112500
0,925,925,1000,544,1544,138000
220,625,845,893,0,893,135000
198,1018,1216,1216,0,1728,156000
0,666,666,1308,1778,3086,301600
0,735,735,735,299,1034,109000
0,882,882,882,0,882,103200
1030,55,1151,845,436,1281,128500
0,656,656,968,0,968,64500
0,736,736,751,783,1534,148000
0,691,691,691,0,691,86000
242,0,725,1035,616,1651,172000
192,728,920,888,0,888,120000
952,0,952,952,0,952,128500
650,390,1040,1040,1040,2080,135000
0,672,672,672,252,924,122900
336,746,1082,1082,0,1082,119200
196,844,1040,1168,678,1846,143000
534,246,876,988,0,988,119000
432,432,864,1238,0,1238,102000
398,317,864,864,0,864,129000
588,422,1010,1134,0,1134,135000
574,466,1040,1040,0,1040,152000
625,545,1170,1170,0,1170,140000
739,503,1242,1242,0,1242,152000
1098,125,1377,1377,0,1377,156500
0,1800,1800,1800,0,1800,141000
0,0,0,925,0,925,99000
536,169,822,1020,831,1851,187000
540,324,864,876,936,1812,169500
110,312,864,864,0,864,125500
734,162,896,936,0,936,130000
0,850,850,960,0,960,103000
0,264,264,768,664,1432,132000
276,569,845,866,430,1296,127500
782,240,1022,1022,0,1022,89500
936,0,936,936,0,936,140000
0,967,967,967,0,967,99900
0,641,641,1047,0,1047,100000
0,808,808,1072,0,1072,130000
130,550,680,680,494,1174,135000
331,318,649,679,504,1183,120000
168,739,907,1131,0,1131,89471
122,0,570,761,380,1141,85000
250,710,960,960,0,960,108500
0,1075,1075,1156,642,1798,137000
329,357,686,866,0,866,110500
0,968,968,968,0,968,100000
0,725,725,909,863,1772,184900
196,322,728,914,728,1642,145000
0,702,702,842,630,1472,125000
168,448,616,616,616,1232,114000
0,662,662,1422,915,2337,90000
259,667,926,991,659,1650,144100
0,1008,1008,1178,1032,2210,117500
316,371,687,687,671,1358,124500
0,819,819,1312,1142,2454,185000
1046,168,1214,1260,1031,2291,133900
370,779,1149,1149,467,1616,152000
338,1221,1559,1559,0,1559,153500
0,718,718,1576,978,2554,159500
324,588,912,912,336,1248,87000
0,0,0,968,0,968,104500
0,0,0,1382,0,1382,110000
317,212,756,916,144,1060,136500
910,0,910,910,525,1435,128250
645,270,915,1167,0,1167,144000
300,765,1065,915,720,1635,210000
306,422,728,728,546,1274,135000
276,324,600,608,624,1232,128000
375,360,735,869,349,1218,131000
0,884,884,884,0,884,113000
52,809,861,861,548,1409,126000
48,624,672,899,423,1322,132000
0,966,966,1014,412,1426,131750
351,405,756,903,378,1281,132500
0,939,939,939,574,1513,137500
0,832,832,854,0,854,132000
425,459,884,959,408,1367,127500
0,960,960,986,0,986,102000
0,1100,1100,1100,1164,2264,200000
0,764,764,1060,764,1824,180500
0,768,768,752,624,1376,165000
0,750,750,960,356,1316,90000
0,698,698,698,698,1396,153575
336,336,672,672,672,1344,140000
168,0,714,1664,862,2526,136000
0,592,592,933,240,1173,113000
0,969,969,969,245,1214,117000
224,816,1040,1226,592,1818,169500
0,637,637,1108,0,1108,139400
375,366,741,1497,797,2294,202500
0,684,684,773,582,1355,127000
0,780,780,780,595,1375,141000
354,224,976,976,976,1952,212300
375,763,1138,1138,1042,2180,161000
681,0,808,838,477,1315,99500
0,530,530,581,530,1111,101000
197,999,1196,1196,0,1196,109900
360,360,720,854,0,1382,128500
0,925,925,964,925,1889,122000
116,556,672,840,0,840,87000
0,771,771,866,504,1484,50000
288,717,1005,1262,1005,2267,219000
152,977,1598,1636,971,3086,200500
312,444,756,756,378,1134,126000
485,187,672,778,504,1282,108500
925,0,925,999,0,999,130000
785,635,1420,1452,0,1452,158450
513,348,1005,1005,0,1005,115400
903,126,1029,1029,0,1029,118500
68,190,980,1020,0,1020,165000
249,30,1040,1040,0,1040,123000
187,0,814,913,0,913,129000
180,340,894,894,0,894,125000
0,948,948,948,0,948,108000
748,20,768,868,0,868,119900
168,420,876,897,0,897,115000
114,300,943,943,0,943,134500
763,192,955,955,0,955,127000
492,402,894,894,0,894,129000
0,660,660,1285,0,1285,143500
216,261,912,912,0,912,129000
386,332,1240,1375,0,1375,187000
267,404,671,1567,1087,2654,158000
0,816,816,1416,0,1416,112000
258,422,680,798,504,1302,165250
736,231,967,1299,0,1299,150000
190,95,1158,1176,0,1176,137000
0,0,0,998,0,998,89500
1219,424,1643,1824,0,1824,302000
299,0,1190,1522,0,1522,182000
831,320,1151,1164,896,2060,211000
300,109,409,1325,0,1325,216000
587,486,1073,1630,0,1630,130000
0,484,484,1242,0,1242,109900
353,935,1288,2422,0,2422,255000
477,725,1202,2158,0,2158,243000
491,497,988,988,638,1626,154000
453,411,864,864,0,864,118000
0,0,0,943,0,943,80000
1440,0,1440,1440,0,1440,150000
348,180,528,605,0,605,86000
283,0,1038,1038,0,1038,130000
557,785,1342,1342,0,1342,125000
1080,0,1080,1080,400,1480,136500
0,951,951,986,376,1362,96000
0,0,0,1340,0,1340,120000
0,1105,1105,1105,717,1822,228500
738,172,910,1442,0,1442,179900
700,0,700,1122,1121,2243,225000
28,0,1502,1553,1177,2730,301000
48,422,1104,912,1215,2127,238000
421,386,807,1175,807,1982,228500
497,282,779,1029,929,1958,220000
984,280,1264,1282,1414,2696,383970
1150,316,1466,1466,1362,2828,424870
0,1643,1643,1651,0,1651,250000
0,2140,2140,2140,0,2140,360000
0,1494,1494,1494,0,1494,279500
0,1316,1316,1316,0,1316,200141
0,1643,1643,1651,0,1651,246500
0,1482,1482,1482,1092,2574,276000
925,349,1274,1274,0,1274,203000
0,728,728,728,728,1456,155835
0,1240,1240,1240,0,1240,194000
664,544,1208,1208,0,1208,195400
20,1526,1546,1546,0,1546,217000
36,1453,1489,1500,0,1500,212999
0,1270,1270,1270,0,1270,175900
0,879,879,879,916,1795,191000
24,1290,1314,1314,0,1314,176432
1065,92,1157,1180,882,2062,277000
608,0,929,946,927,1873,207000
697,747,1444,1444,700,2144,277000
985,595,1580,1079,874,1953,240000
568,264,832,976,1111,2087,187500
51,0,966,1743,0,1743,279000
550,472,1022,1022,0,1022,139500
495,495,990,990,0,990,126000
334,322,1200,1200,0,1200,177500
539,96,635,646,662,1308,175000
706,88,794,882,914,1796,211000
420,570,990,990,0,990,146000
549,548,1097,1097,0,1097,147900
588,402,990,990,0,990,123600
648,176,824,905,881,1786,204750
342,646,988,988,885,1873,235500
638,215,853,853,900,1753,217000
0,845,845,845,845,1690,190550
841,144,985,985,857,1842,217500
1013,440,1453,1479,0,1479,226000
0,840,840,840,828,1668,180000
663,201,864,894,0,894,131000
502,513,1015,1025,0,1025,153500
755,240,995,1009,0,1009,160000
539,501,1040,1040,0,1040,134900
60,399,876,907,0,907,130000
330,102,864,879,0,879,120000
138,276,882,882,0,882,112500
716,253,969,969,0,969,122000
671,193,864,864,0,864,127000
385,0,385,875,0,875,117000
1464,536,2000,2000,0,2000,305900
0,1284,1284,1284,885,2169,228500
1412,261,1673,1673,0,1673,270000
0,1459,1459,1459,0,1459,192000
654,325,979,992,940,1932,213000
0,860,860,860,869,1729,200000
281,747,1028,1210,1242,2452,267000
408,683,1556,1592,0,1592,228000
1198,333,1531,1531,908,2439,275000
762,98,860,1212,780,1992,211000
1059,567,1626,1668,0,1668,285000
1079,141,1220,1220,870,2090,240000
659,189,848,848,0,848,131500
915,426,1341,1341,0,1341,246900
0,847,847,847,1081,1928,219500
699,638,1337,1337,0,1337,185000
0,738,738,738,738,1476,179400
0,939,939,939,858,1797,213500
0,1422,1422,1422,0,1422,179600
709,460,1169,1190,0,1190,173500
0,1330,1330,1330,0,1330,167840
0,738,738,738,753,1491,168675
0,768,768,768,768,1536,167000
698,420,1214,1214,0,1214,140000
936,0,936,936,0,936,118500
132,115,1088,1088,0,1088,110000
520,440,960,960,0,960,94750
130,666,901,901,450,1351,122000
0,1179,1179,1179,0,1179,110000
816,0,816,816,0,816,118500
504,456,960,1044,0,1044,133500
751,392,1143,1113,0,1113,148000
0,0,0,1100,1133,2233,141000
0,1125,1125,1125,0,1125,155000
980,110,1090,1090,0,1090,157000
611,123,734,734,674,1408,171500
4010,1085,5095,5095,0,5095,183850
2260,878,3138,3138,1538,4676,184750
467,80,547,1072,0,1072,140000
77,52,960,960,0,960,131750
0,0,0,1152,0,1152,61500
492,372,864,948,0,948,111000
0,1195,1195,1195,0,1195,98500
544,0,544,774,0,774,79000
144,238,660,740,125,865,108500
552,342,894,894,0,894,110000
0,560,560,796,550,1346,112000
544,224,768,768,0,768,125000
682,182,864,864,0,864,79275
732,216,948,948,0,948,119000
256,1184,1440,1440,1440,3395,200000
371,925,1296,1296,1296,2592,150000
0,602,602,900,602,1502,165000
0,768,768,789,0,789,96500
319,971,1290,1422,0,1422,136500
113,538,651,759,539,1298,146500
569,162,731,981,787,1768,175000
246,285,531,567,531,1098,148500
0,585,585,851,585,1436,141500
0,912,912,912,514,1426,189950
0,686,686,686,775,1461,135000
364,554,918,918,728,1646,164000
365,75,440,694,0,694,90350
0,661,661,661,589,1250,139000
0,920,920,954,0,954,119750
484,495,979,979,979,1958,145000
284,717,1001,1001,1001,2002,145000
0,851,851,867,851,1718,238000
0,0,0,1226,0,1226,153500
1128,242,1370,1370,1254,2624,239000
428,537,965,1940,1254,3194,359100
189,741,930,1230,525,1755,188000
297,0,854,1096,895,1991,220000
533,195,728,760,595,1355,140000
297,556,853,1549,1178,2727,315000
774,104,1028,1436,884,2320,259500
1186,291,1477,1839,0,1839,257500
410,390,800,960,780,1740,219500
35,905,1809,2259,0,2259,217000
540,0,1560,1560,0,1560,201000
813,675,1488,1488,0,1488,215000
330,186,516,529,516,1045,123900
0,1680,1680,1680,0,1680,170000
577,427,1004,1020,0,1020,200000
434,1262,1696,1696,0,1696,198000
1219,816,2035,2515,0,2515,200624
0,279,279,2726,0,2726,315000
0,793,793,997,520,1517,115000
375,345,720,720,495,1215,141000
116,604,720,803,0,803,87000
0,936,936,936,665,1601,129850
0,732,732,772,351,1123,100000
548,311,859,942,886,1828,150909
0,816,816,816,0,816,75200
0,1012,1012,1012,0,1012,118400
0,961,961,1077,0,1077,67000
420,490,910,910,648,1558,152000
0,0,0,640,0,845,68104
0,957,957,1034,957,1991,119600
967,106,1073,1073,0,1073,140000
737,100,837,1001,0,1001,124900
1573,0,1573,1625,0,1625,375000
1573,0,1573,1625,0,1625,235000
1001,0,1001,1299,0,1299,183500
773,115,888,912,0,912,156000
336,748,1084,1080,0,1080,134000
585,856,1441,1392,0,1392,215000
1392,17,1409,1409,0,1409,245000
1239,215,1454,1478,0,1478,210000
224,98,852,918,0,918,148000
924,46,970,1026,0,1026,143000
949,552,1501,1501,0,1501,244000
1102,328,1502,1502,0,1502,330000
967,383,1350,1328,0,1328,170000
0,585,585,2279,0,2279,257000
0,1689,1689,1689,0,1689,231713
583,963,1546,1564,0,1564,267300
428,1048,1476,1484,0,1484,265900
0,1571,1571,1571,0,1571,239000
0,1638,1638,1646,0,1646,248900
215,970,1265,1240,0,1240,174000
902,254,1156,1187,530,1717,187500
742,130,872,888,868,1756,204000
250,1017,1267,1312,0,1312,180500
786,82,868,1146,0,1146,187500
1329,593,1922,1922,0,1922,282000
0,1491,1491,1491,0,1491,178000
1300,316,1616,1629,0,1629,270000
766,356,1122,1146,1340,2486,279900
1159,413,1572,1572,0,1572,186700
80,1652,1732,1776,0,1776,283463
0,1824,1824,1824,0,1824,392000
0,1094,1094,1133,1349,2482,281213
206,914,1120,1120,0,1120,147000
0,0,0,2034,0,2034,130000
16,0,920,936,0,936,140000
633,431,1064,1040,0,1040,132250
0,1632,1632,1632,0,1632,143000
1159,90,1249,1622,0,1622,168000
840,200,1040,1060,0,1060,129900
874,268,1142,1142,0,1142,134000
252,294,546,546,546,1092,85500
503,27,530,530,462,992,106500
384,162,546,546,546,1092,93900
0,546,546,546,546,1092,75000
131,0,630,630,0,630,84500
0,546,546,546,546,1092,75190
539,490,1029,1062,0,1062,146800
923,0,923,1008,0,1008,153500
1148,96,1244,1356,0,1356,188000
1112,48,1160,1676,0,1676,196000
531,185,716,716,716,1432,157000
796,0,796,796,0,796,138000
619,149,768,768,0,768,129500
811,585,1396,1608,0,1608,80000
565,280,845,845,0,845,129500
1090,0,1090,1178,0,1178,135000
546,270,816,816,0,816,124500
596,220,816,816,0,816,139000
212,762,974,974,0,974,93500
516,348,864,887,0,887,124500
468,171,1178,1293,0,1293,149900
773,235,1008,1024,0,1024,157500
1127,490,1617,1797,0,1797,169000
1110,595,1705,1390,0,1390,252000
0,1851,1851,1851,0,1851,192100
700,113,813,813,712,1525,183500
0,964,964,993,1243,2236,222000
0,781,781,781,890,1671,170000
592,99,691,691,807,1498,187500
0,821,821,821,955,1776,202000
714,88,802,802,709,1511,185000
57,1335,1392,1392,1070,2462,320000
0,1670,1670,1670,0,1670,240000
0,1074,1074,1074,990,2064,250000
0,893,893,901,900,1801,239900
60,1640,1700,1700,512,2212,309000
0,868,868,887,1134,2021,274725
0,2062,2062,2079,608,2687,270000
705,455,1160,1169,0,1169,183500
518,179,697,697,804,1501,165600
0,935,935,955,677,1632,176500
0,1191,1191,1204,0,1204,130000
495,354,1064,1064,703,1767,239000
1148,594,1742,1742,0,1742,275000
1218,180,1398,1414,1384,2798,457347
0,1528,1528,1528,1862,3390,545224
205,889,1094,1102,1371,2473,356383
240,1752,1992,1992,876,2868,556581
0,1234,1234,1264,1312,2576,361919
1206,644,1850,1850,848,2698,535000
0,1390,1390,1390,1405,2795,401179
0,1410,1410,1426,1519,2945,438780
0,0,0,1547,720,2320,169000
1056,0,1056,1056,0,1056,145000
1191,523,1714,1714,0,1714,318000
1422,392,1814,1826,0,1826,319000
1416,494,1910,2000,0,2000,470000
213,995,1208,1621,0,1621,202500
1002,0,1204,1377,806,2183,229000
795,0,795,1468,795,2263,235000
712,84,796,790,784,1574,190000
850,138,988,1102,0,1102,169000
929,916,1845,1872,0,1872,241500
0,945,945,945,912,1857,188900
625,0,1686,1686,0,1686,207500
790,133,1392,1392,1392,2784,250000
550,163,713,811,741,1552,179900
1005,42,1047,1083,0,1083,172000
788,172,960,960,1358,2318,294323
548,127,675,1109,766,1875,184500
788,268,1056,1074,0,1074,153500
194,638,832,832,832,1664,162900
663,0,1040,1309,0,1309,181000
755,348,1103,1103,0,1103,155000
75,230,1096,1096,0,1096,138800
0,864,864,864,0,864,116050
614,244,858,858,0,858,88000
20,224,864,874,0,874,97500
951,536,1487,1419,0,1419,190000
0,525,525,525,567,1092,105500
402,363,765,765,600,1365,125500
309,174,483,483,504,987,83000
282,212,494,494,536,1030,116000
0,672,672,672,546,1218,91500
317,355,672,672,546,1218,118000
276,207,483,483,465,948,89000
382,143,525,525,567,1092,108000
0,483,483,483,504,987,94500
727,186,1069,1069,0,1069,146300
373,462,943,1387,0,1387,145000
769,95,864,900,0,900,123000
120,443,1055,1055,0,1055,137500
70,785,855,855,601,1456,144000
1447,533,1980,1980,0,1980,315000
1369,369,1738,1738,851,2589,412083
0,1249,1249,1249,1347,2596,342643
0,1618,1618,1618,0,1618,252000
1386,690,2076,2076,0,2076,465000
0,1721,1721,1740,0,1740,293000
1505,363,1868,1868,0,1868,415000
1261,572,1833,1850,0,1850,326000
0,1158,1158,1158,1218,2376,325300
0,1117,1117,1132,1320,2452,309000
0,1090,1090,1117,1089,2206,300000
0,1030,1030,1038,1060,2098,275500
1290,316,1606,1625,466,2091,338500
998,177,1175,1182,1142,2324,345000
0,1209,1209,1209,1044,2253,344133
0,1054,1054,1054,1335,2389,298236
880,644,1524,1544,814,2358,329900
1274,622,1896,1944,0,1944,360000
0,1085,1085,1120,850,1970,281000
1232,560,1792,1792,0,1792,372397
1383,397,1780,1780,0,1780,378000
1567,225,1792,1792,0,1792,374000
1410,438,1848,1848,880,2728,437154
546,512,1058,1058,846,1904,275000
994,426,1420,1426,488,1914,279000
659,705,1364,1364,0,1364,185850
472,1088,1560,1565,0,1565,282500
0,1368,1368,1368,0,1368,202500
0,1368,1368,1368,0,1368,202665
1023,663,1686,1686,0,1686,332200
415,1251,1666,1666,0,1666,310090
0,1405,1405,1405,0,1405,171750
28,1288,1316,1316,0,1316,169990
0,728,728,728,728,1456,170440
0,738,738,738,754,1492,169985
554,100,654,664,832,1496,179665
0,879,879,879,984,1863,219210
0,1326,1326,1326,0,1326,174190
0,728,728,728,728,1456,172785
0,1052,1052,1052,1321,2373,258000
0,738,738,738,754,1492,185101
453,767,1220,1364,0,1364,210250
0,1374,1374,1557,0,1557,234000
0,1273,1273,1456,0,1456,215000
1038,330,1368,1511,0,1511,246990
0,1375,1375,1414,0,1414,178740
1059,306,1365,1548,0,1548,225000
16,1232,1248,1248,0,1248,167240
16,1126,1142,1142,0,1142,156820
16,1346,1362,1506,0,1506,213490
1154,366,1520,1567,0,1567,264561
1070,286,1356,1500,0,1500,246578
0,732,732,734,1104,1838,192140
457,326,783,807,702,1509,183200
0,707,707,707,707,1414,178000
0,848,848,848,750,1598,201490
0,1406,1406,1454,482,1936,230500
0,783,783,807,702,1509,180000
0,953,953,953,711,1664,172400
732,250,982,1008,881,1889,215000
0,930,930,956,930,1886,199900
786,173,959,959,712,1671,173000
0,1035,1035,1082,1240,2322,287602
0,975,975,1005,1286,2291,230000
1074,322,1396,1407,985,2392,348000
791,253,1044,1079,897,1976,286000
505,655,1160,1205,1029,2234,300000
1387,543,1930,1831,1796,3627,625000
1182,358,1540,1540,1315,2855,405000
956,130,1086,1086,838,1924,280000
0,1141,1141,1165,1098,2263,258000
527,815,1342,1358,1368,2726,350000
292,48,1733,1933,1567,3500,584500
380,742,1290,1305,1189,2494,321000
740,425,1165,1203,1323,2526,290000
247,0,1286,1565,1234,2799,315000
0,1100,1100,1116,848,1964,252000
1562,108,1670,1670,0,1670,336820
1721,356,2077,2097,0,2097,423000
1220,440,1660,1660,0,1660,290000
0,1616,1616,1616,0,1616,232000
0,1504,1504,1504,0,1504,199000
24,1254,1278,1278,0,1278,198600
1836,200,2036,2036,604,2640,405749
0,1489,1489,1489,0,1489,232600
0,1095,1095,1095,844,1939,266000
0,756,756,756,797,1553,186500
0,858,858,858,858,1716,200825
0,770,770,778,798,1576,197000
905,357,1262,1262,0,1262,185000
0,1257,1257,1266,0,1266,176000
0,1293,1293,1301,0,1301,187750
24,1118,1142,1142,0,1142,139500
0,1400,1400,1400,0,1400,186800
0,1131,1131,1131,0,1131,132000
0,1141,1141,1141,0,1141,142500
941,217,1158,1158,0,1158,158000
0,891,891,891,795,1686,184000
0,784,784,831,754,1585,184900
0,941,941,941,896,1837,187000
387,374,761,810,793,1603,175900
758,78,836,844,887,1731,248500
904,494,1398,1398,0,1398,172000
278,939,1217,1217,0,1217,151000
274,362,636,636,684,1320,150000
1056,0,1056,1056,0,1056,107000
641,187,828,965,0,965,119900
36,952,988,988,0,988,129500
1332,396,1728,1728,0,1728,125000
0,0,0,1286,368,1654,119500
612,252,864,1211,0,1211,144000
506,0,506,1212,0,1212,151000
554,430,984,984,0,984,126000
162,450,882,909,0,909,116000
181,744,925,925,0,925,133500
712,312,1024,1024,0,1024,120875
560,0,935,935,0,935,137000
644,268,912,912,0,912,124000
465,447,912,1236,0,1236,135000
659,253,912,941,0,941,129200
1023,228,1748,2151,495,2646,260000
0,1288,1288,1301,1116,2417,260000
1118,216,1334,1520,1306,2826,334000
1012,326,1338,1352,1168,2520,310000
728,367,1095,1166,1129,2295,268000
1456,168,1624,1624,0,1624,262000
0,1143,1143,1143,0,1143,176400
1039,208,1247,1247,0,1247,197000
0,600,600,520,600,1200,151000
0,600,600,520,623,1223,147400
0,600,600,520,623,1223,149900
0,600,600,520,600,1200,144152
353,403,756,768,756,1524,166000
450,241,691,713,739,1452,183900
641,32,673,673,709,1382,165000
0,530,530,530,550,1080,139000
0,569,569,854,840,1694,200000
0,1568,1568,1568,0,1568,221000
437,0,1494,1494,0,1494,270000
767,441,1208,1208,0,1208,165000
1009,44,1235,1235,0,1235,214000
860,176,1036,1036,0,1036,188000
807,419,1226,1226,0,1226,190000
652,48,1226,1226,0,1226,170000
1810,32,1842,1842,0,1842,385000
962,191,1153,1193,0,1193,146500
0,570,570,1222,698,1920,170000
297,1203,1568,2156,0,2156,262500
404,304,708,708,708,1416,179900
619,435,1054,1512,1142,2654,250000
247,485,732,1012,778,1790,165150
553,713,1334,1334,0,1334,164500
0,1164,1164,1164,0,1164,140000
400,100,980,980,0,980,135500
758,293,1051,1051,0,1051,142000
361,56,900,884,886,1770,155000
760,216,976,976,0,976,157500
1016,36,1052,1052,0,1052,138500
744,89,833,898,0,898,140000
799,252,1051,1051,0,1051,124400
602,137,1141,1141,0,1141,158000
661,203,864,1200,0,1200,146000
416,409,825,1097,896,1993,190000
915,135,1050,1050,0,1050,136500
521,169,864,864,0,864,129900
528,1098,1626,1712,0,1712,145000
901,34,1187,1565,0,1565,185900
553,698,1251,1251,0,1251,160000
260,0,1008,1488,0,1488,167000
360,360,720,720,720,1440,157500
513,75,588,1095,0,1095,140000
567,413,1008,1053,0,1053,150000
632,616,1248,1248,0,1248,151500
574,242,816,816,0,816,129800
486,522,1008,1008,0,1008,137000
0,938,938,1043,0,1043,137000
384,363,747,774,456,1230,121600
0,440,440,869,0,869,85500
0,600,600,747,0,747,79900
0,504,504,936,316,1252,127000
915,336,1251,1433,0,1433,161000
40,1404,1444,1624,0,1624,146500
996,60,1056,1216,0,1216,135000
756,1380,2136,2136,0,2136,137900
403,238,806,958,620,1578,133000
0,704,704,1024,704,1728,137000
486,450,936,936,0,936,121000
0,1584,1584,1584,0,1584,119000
939,307,1246,1246,0,1246,172000
600,635,1235,1235,0,1235,98600
445,479,924,1216,941,2157,226000
812,124,936,1128,0,1128,118000
1036,140,1360,1360,1360,3112,235000
0,1008,1008,1008,0,1008,135000
803,303,1106,1190,0,1190,132500
748,102,1144,1144,0,1144,143000
623,556,1179,1364,0,1364,132000
565,818,1383,1383,0,1383,145250
203,918,1121,1336,0,1336,162000
678,99,1058,1370,0,1370,148000
895,197,1092,1092,0,1092,141000
914,210,1124,1124,0,1124,153000
360,710,1070,1236,0,1236,134450
943,0,943,943,0,943,135960
824,226,1050,1050,0,1050,156000
0,1367,1367,1375,0,1375,140000
658,350,1008,1008,0,1008,139500
0,216,216,1575,0,1575,155000
271,30,301,1145,0,1145,127000
488,517,1005,1005,0,1005,133500
144,0,1056,1056,0,1056,125000
741,143,884,884,0,884,142000
0,929,929,2039,0,2039,167000
494,521,1015,1384,0,1384,159000
1018,1153,2171,1392,1248,2640,180000
0,784,784,900,412,1312,127000
617,0,617,865,445,1310,112000
0,713,713,713,0,713,99800
415,418,833,833,0,833,117000
0,1073,1073,1073,0,1073,108480
0,715,715,715,0,715,68000
0,448,448,448,272,720,86900
821,299,1120,1130,0,1130,120000
338,325,663,774,821,1595,155500
0,1077,1077,981,779,1760,80000
0,672,672,694,520,1214,105000
664,290,954,1766,648,2414,160000
626,170,796,1096,370,1466,170000
643,445,1088,1324,0,1324,160000
516,380,1024,1086,0,1086,159950
580,503,1083,1146,0,1146,165000
600,312,912,1085,649,1734,159000
701,434,1135,1207,0,1207,147000
312,0,912,912,0,912,115000
655,0,655,1194,0,1194,159500
414,450,864,864,0,864,120000
708,108,816,816,0,816,129900
913,400,1313,1773,0,1773,183000
0,0,0,1472,0,1472,157500
636,802,1438,1900,548,2448,277500
1277,207,1484,1600,0,1600,207500
455,455,910,910,611,1521,147500
0,720,720,720,472,1192,135000
0,0,0,1040,0,1040,109500
0,0,0,1040,0,1040,109900
369,671,1040,1040,0,1040,133700
0,0,0,1040,0,1040,81400
0,0,0,1040,0,1040,87500
0,0,0,1040,0,1040,93500
0,1556,1556,1556,0,1556,119000
179,465,1150,1150,0,1150,141000
781,369,1150,1150,0,1150,146000
512,148,660,660,688,1348,155000
784,141,925,999,0,999,134500
809,236,1045,1045,0,1045,120000
468,396,864,864,0,864,105000
953,72,1025,1025,0,1025,124000
0,716,716,1007,1007,2014,169000
0,686,686,810,518,1328,107000
276,936,1212,1226,442,1668,135000
284,863,1147,1147,510,1657,111500
381,399,780,940,476,1416,156500
16,712,728,832,809,1641,178000
208,504,712,848,580,1428,139900
0,502,502,502,502,1004,105000
0,813,813,813,0,813,110000
0,938,938,1084,867,1951,111500
143,817,1032,1032,0,1032,108000
0,844,844,844,0,844,111500
0,636,636,1089,661,1750,124000
0,576,576,864,0,864,105000
0,648,648,734,384,1118,116000
0,738,738,714,662,1376,96900
576,384,960,960,0,960,135500
0,816,816,816,750,1566,139000
416,76,492,492,0,492,61500
310,460,770,885,297,1182,120000
256,906,1162,1163,0,1163,126175
0,798,798,840,0,840,64000
0,1020,1020,908,1020,1928,137000
0,1095,1095,1095,679,1774,87000
390,490,880,880,888,1768,163000
0,1226,1226,1226,878,2104,155000
0,540,540,889,551,1440,79000
0,815,815,815,875,1690,144000
0,684,684,684,684,1368,114504
0,596,596,998,764,1762,157000
0,1200,1200,1200,0,1200,125000
0,1107,1107,1518,1518,3608,475000
0,624,624,624,624,1248,93500
0,960,960,960,0,960,125000
0,1020,1020,1020,0,1020,64500
266,522,788,788,0,788,100000
0,972,972,972,605,1577,140200
0,848,848,1017,810,1827,202500
399,605,1004,1004,660,1664,159000
507,286,793,793,325,1118,119900
0,816,816,816,0,1176,114500
0,896,896,896,448,1344,115000
347,381,728,728,434,1162,75000
489,279,768,1015,0,1015,88000
0,0,0,672,240,912,80500
0,1042,1042,1042,534,1576,149000
0,741,741,741,583,1324,110000
397,706,1103,1103,0,1103,110500
616,0,616,616,0,616,89000
0,993,993,1048,0,1048,113000
0,816,816,816,0,816,109000
0,1595,1595,1611,875,2486,220000
789,171,960,960,0,960,129000
0,485,485,1001,634,1635,117000
0,693,693,693,0,693,52500
0,596,596,834,596,1430,107000
0,396,396,665,665,1330,116500
0,610,610,819,0,819,72000
0,780,780,780,596,1376,119500
0,803,803,803,557,1360,125500
0,1007,1007,1077,0,1077,91000
490,30,520,520,0,754,84500
343,641,984,984,0,984,90000
329,477,806,1081,341,1422,137500
0,1921,1921,1921,0,1921,150000
0,0,0,1640,0,1640,131000
300,468,1062,1352,0,1352,130000
0,0,0,1032,0,1032,125000
0,830,830,879,0,879,80000
510,190,1073,1073,0,1073,157000
547,504,1051,1382,0,1382,148000
0,0,0,1296,0,1296,90000
663,396,1059,1068,0,1068,154500
779,285,1064,1064,0,1064,153600
328,285,1164,1320,0,1320,164500
456,456,912,934,0,934,132000
773,286,1059,1059,0,1059,142500
673,378,1051,1159,0,1159,158000
209,463,672,672,728,1400,149500
194,0,1176,1458,0,1458,165000
570,891,1461,1721,0,1721,180000
794,166,960,1040,0,1040,160500
0,1967,1967,1967,0,1967,156500
483,1466,1949,1949,0,1949,157000
57,554,1052,1252,668,1920,172500
168,284,1134,1803,0,1803,155000
306,372,1763,1779,0,1779,170000
0,872,872,872,0,872,105000
648,0,648,960,0,960,145000
988,200,1188,1437,0,1437,168000
810,229,1865,1830,0,1830,278000
104,46,1000,1000,0,1000,164000
603,701,1304,1304,983,2287,225000
535,88,782,810,0,810,130000
762,102,864,894,0,894,142500
397,33,430,880,680,1700,148400
1082,371,1453,1453,0,1453,190000
799,168,967,1350,0,1350,146000
230,569,799,799,351,1150,128000
603,293,896,1112,896,2008,225000
0,697,697,1575,626,2201,274970
0,672,672,1337,672,2009,235000
425,1411,1836,1836,1836,3672,415000
612,0,1776,1560,0,1560,182000
0,0,0,1488,0,1488,135000
0,1057,1057,1057,0,1057,137000
444,550,994,1216,639,1855,136900
468,532,1000,1068,541,1609,149900
210,219,980,1148,0,1148,123500
0,0,0,1124,0,1124,93000
0,810,810,1002,454,1456,91500
1258,40,1298,1298,0,1298,180000
549,319,868,1313,1246,2559,209000
380,397,777,1065,846,1911,215000
261,0,1344,1440,0,1440,224500
0,1308,1308,1308,568,1876,229800
393,815,1208,1208,0,1208,183600
684,515,1199,1220,0,1220,194000
0,1286,1286,1294,0,1294,193879
20,1594,1614,1614,0,1614,221500
0,1498,1498,1498,0,1498,204900
464,927,1391,1391,571,1962,239799
1576,260,1836,1846,0,1846,233555
1300,434,1734,1734,0,1734,260000
1122,448,1570,1590,0,1590,294900
0,945,945,945,864,1809,209700
56,1558,1614,1614,0,1614,225000
0,784,784,784,812,1596,181000
789,119,908,927,988,1915,220000
812,812,1624,1582,0,1582,190000
938,0,938,988,0,988,180000
655,878,1533,1533,0,1533,280000
853,535,1388,1388,0,1388,158900
298,572,870,914,0,914,148000
0,1100,1100,1100,0,1100,145000
0,781,781,795,704,1499,187000
846,579,1425,1425,0,1425,193000
716,274,990,990,0,990,156000
1400,125,1525,1525,0,1525,235000
1200,279,1479,1494,0,1494,217000
1162,426,1588,1588,0,1588,214000
500,342,842,856,893,1749,196000
894,57,951,951,828,1779,217000
700,216,916,920,941,1861,200000
0,936,936,936,840,1776,192500
0,1541,1541,1541,0,1541,205000
483,428,911,954,0,954,132500
509,166,675,686,702,1388,157500
595,0,995,1282,0,1282,174000
523,448,971,971,0,971,128500
360,504,864,864,0,864,128500
894,0,894,894,0,894,149900
437,427,864,864,0,864,119900
338,292,630,630,690,1320,137000
932,133,1065,1091,898,1989,255000
456,370,826,878,884,1762,222000
639,201,840,840,915,1755,214000
872,476,1348,1358,0,1358,220000
0,1753,1753,1787,0,1787,275000
0,872,872,872,1037,1909,197000
986,668,1654,1654,0,1654,230000
920,170,1090,1090,1124,2214,268500
0,1065,1065,1065,984,2049,210900
796,258,1054,1070,869,1939,227000
685,245,930,950,1045,1995,237000
975,133,1108,1108,989,2097,274300
24,1836,1860,1836,0,1836,216837
717,131,848,848,0,848,133000
662,186,848,848,0,848,155900
0,1079,1079,1079,840,1919,233230
1000,390,1390,1390,0,1390,207000
0,847,847,847,1101,1948,195000
340,1342,1682,1700,0,1700,200000
0,851,851,851,886,1737,203160
0,784,784,784,827,1611,195800
24,1528,1552,1552,0,1552,212900
0,860,860,860,860,1720,196500
996,340,1336,1336,0,1336,198000
0,750,750,750,750,1500,173900
0,728,728,728,728,1456,163990
24,1286,1310,1310,0,1310,164990
173,166,676,760,676,1436,98000
176,1290,1466,1466,0,1466,149900
836,0,836,1220,0,1220,102000
976,0,976,1012,0,1012,127500
945,0,945,980,0,980,127500
847,329,1176,1176,0,1176,119900
0,796,796,806,918,1724,196500
475,142,914,914,0,914,117250
0,1150,1150,1164,1150,2314,229000
547,0,547,1072,0,1072,145000
547,0,547,1072,0,1072,140000
547,0,547,1072,0,1072,142500
0,970,970,970,739,1709,134000
0,970,970,970,739,1709,130000
0,970,970,970,739,1709,130000
0,970,970,970,739,1709,137500
0,976,976,976,732,1708,130000
0,624,624,624,312,936,97900
0,832,832,846,492,1338,92000
0,1093,1093,1093,576,1669,107000
0,658,658,658,526,1184,81000
392,392,784,949,272,1221,104900
167,697,864,864,0,864,115000
691,263,954,1482,0,1482,125000
0,686,686,686,564,1250,116000
0,864,864,964,0,1414,83000
0,795,795,954,795,2230,118500
0,498,498,498,0,498,35000
0,616,616,1055,218,1273,121000
0,686,686,948,980,1928,160000
388,552,940,1192,403,1595,140000
930,128,1058,1058,493,1551,137000
780,0,780,816,524,1340,128000
424,200,624,743,736,1479,160000
0,747,747,892,892,1784,138887
305,450,755,755,755,1510,149000
0,1008,1008,1008,0,1522,102000
0,818,818,818,818,1636,167000
352,441,793,901,901,1802,200100
646,346,992,992,473,1465,131000
384,440,824,824,464,1288,112000
216,540,756,961,756,1717,140000
0,817,817,940,610,1550,195000
0,792,792,792,725,1517,230000
602,299,901,1125,592,1717,194000
0,700,700,1180,0,1180,137500
223,794,1017,1020,1037,2057,250000
526,496,1022,1122,549,1671,218000
503,449,952,1170,1175,2345,239000
0,637,637,959,650,1609,199500
0,697,697,1104,697,1801,210000
296,230,1073,1811,0,1811,230000
1283,0,1430,1647,0,1647,217500
760,408,1168,1278,1037,2315,257000
841,324,1165,1336,0,1336,157000
1110,734,1844,1844,0,1844,223000
305,671,976,976,0,976,102000
374,487,861,861,424,1285,145400
0,432,432,672,0,672,72000
0,641,641,641,0,641,85000
285,666,951,951,0,951,106500
0,967,967,967,671,1638,139000
637,0,637,897,439,1336,108000
0,0,0,729,0,729,51689
50,430,480,480,0,480,35311
0,660,660,1060,336,1396,115000
0,216,216,576,360,936,78000
1573,0,1573,1778,0,1778,375000
1564,30,1594,1646,0,1646,300000
776,849,1625,1625,0,1625,242500
0,1664,1664,1664,0,1664,145000
0,1491,1491,1491,0,1491,209000
975,0,975,1004,0,1004,135000
576,552,1128,1210,0,1210,148000
0,1907,1907,1959,0,1959,171000
965,245,1210,1238,1281,2519,335000
0,0,0,1295,0,1295,230000
909,723,1632,1650,0,1650,250764
0,1686,1686,1707,0,1707,228000
980,92,1112,1137,0,1137,176000
1053,256,1309,1339,0,1339,180000
1216,0,1216,1298,1216,2514,250000
1136,129,1381,1403,0,1403,202000
1274,526,1800,1800,0,1800,312500
1350,378,1728,1960,0,1960,320000
1460,408,1868,2028,0,2028,369900
1455,383,1838,1838,0,1838,359900
0,0,0,1600,0,1600,81500
1243,45,1288,1368,0,1368,215000
897,319,1216,1216,0,1216,164000
1201,36,1237,1337,0,1337,153500
0,1140,1140,1140,0,1140,84500
0,264,264,616,688,1304,104500
548,36,757,925,550,1475,127000
837,105,942,1291,1230,2521,151400
441,423,864,874,0,874,126500
149,1503,1652,1652,0,1652,146500
522,108,630,630,0,630,73000
252,294,546,546,546,1092,79400
119,641,1104,1360,0,1360,140000
553,77,630,630,0,630,92000
408,138,546,546,546,1092,87550
0,546,546,546,546,1092,79500
0,546,546,546,546,1092,90500
252,294,546,546,546,1092,71000
936,396,1728,1728,0,1728,150900
1606,122,1728,1728,0,1728,188000
936,190,1126,1126,0,1126,160000
1224,0,1224,1224,0,1224,131000
819,184,1003,1003,0,1003,142500
301,239,864,902,0,902,131000
337,575,912,970,0,970,132000
1071,195,1389,1389,0,1389,170000
758,238,996,996,1004,2000,188000
